"year","name","DEM_VOTES_2016","REP_VOTES_2016","TOTAL_VOTES_2016","DEM_PRCT_2016","REP_PRCT_2016","LEAN_2016","DEM_VOTES_2020","REP_VOTES_2020","TOTAL_VOTES_2020","DEM_PRCT_2020","REP_PRCT_2020","LEAN_2020"
2008,"AL-01",103896,194251,298147,34.85,65.15,32.52,117680,212973,330653,35.59,64.41,33.36
2008,"AL-02",96889,181170,278059,34.84,65.16,32.54,109133,191935,301068,36.25,63.75,32.04
2008,"AL-03",111208,166720,277928,40.01,59.99,22.2,125089,185738,310827,40.24,59.76,24.06
2008,"AL-04",41342,233690,275032,15.03,84.97,72.16,46179,258022,304201,15.18,84.82,74.18
2008,"AL-05",104581,206542,311123,33.61,66.39,35,137734,235942,373676,36.86,63.14,30.82
2008,"AL-06",96349,262483,358832,26.85,73.15,48.52,130327,281884,412211,31.62,68.38,41.3
2008,"AL-07",175343,73773,249116,70.39,29.61,-38.56,183481,74676,258157,71.07,28.93,-37.6
2010,"AL-01",103896,194251,298147,34.85,65.15,32.52,117680,212973,330653,35.59,64.41,33.36
2010,"AL-02",96889,181170,278059,34.84,65.16,32.54,109133,191935,301068,36.25,63.75,32.04
2010,"AL-03",111208,166720,277928,40.01,59.99,22.2,125089,185738,310827,40.24,59.76,24.06
2010,"AL-04",41342,233690,275032,15.03,84.97,72.16,46179,258022,304201,15.18,84.82,74.18
2010,"AL-05",104581,206542,311123,33.61,66.39,35,137734,235942,373676,36.86,63.14,30.82
2010,"AL-06",96349,262483,358832,26.85,73.15,48.52,130327,281884,412211,31.62,68.38,41.3
2010,"AL-07",175343,73773,249116,70.39,29.61,-38.56,183481,74676,258157,71.07,28.93,-37.6
2012,"AL-01",103130,192414,295544,34.89,65.11,32.44,116897,211122,328019,35.64,64.36,33.26
2012,"AL-02",96285,185824,282109,34.13,65.87,33.96,109614,196481,306095,35.81,64.19,32.92
2012,"AL-03",93312,188328,281640,33.13,66.87,35.96,108762,211614,320376,33.95,66.05,36.64
2012,"AL-04",50774,234353,285127,17.81,82.19,66.6,56781,260687,317468,17.89,82.11,68.76
2012,"AL-05",97148,200493,297641,32.64,67.36,36.94,129793,228296,358089,36.25,63.75,32.04
2012,"AL-06",88532,234087,322619,27.44,72.56,47.34,119055,248483,367538,32.39,67.61,39.76
2012,"AL-07",200428,83131,283559,70.68,29.32,-39.14,208722,84487,293209,71.19,28.81,-37.84
2014,"AL-01",103130,192414,295544,34.89,65.11,32.44,116897,211122,328019,35.64,64.36,33.26
2014,"AL-02",96272,185822,282094,34.13,65.87,33.96,109600,196479,306079,35.81,64.19,32.92
2014,"AL-03",93312,188328,281640,33.13,66.87,35.96,108762,211614,320376,33.95,66.05,36.64
2014,"AL-04",50774,234353,285127,17.81,82.19,66.6,56781,260687,317468,17.89,82.11,68.76
2014,"AL-05",97148,200493,297641,32.64,67.36,36.94,129793,228296,358089,36.25,63.75,32.04
2014,"AL-06",88532,234087,322619,27.44,72.56,47.34,119055,248483,367538,32.39,67.61,39.76
2014,"AL-07",200441,83132,283573,70.68,29.32,-39.14,208736,84489,293225,71.19,28.81,-37.84
2016,"AL-01",103130,192414,295544,34.89,65.11,32.44,116897,211122,328019,35.64,64.36,33.26
2016,"AL-02",96272,185822,282094,34.13,65.87,33.96,109600,196479,306079,35.81,64.19,32.92
2016,"AL-03",93312,188328,281640,33.13,66.87,35.96,108762,211614,320376,33.95,66.05,36.64
2016,"AL-04",50774,234353,285127,17.81,82.19,66.6,56781,260687,317468,17.89,82.11,68.76
2016,"AL-05",97148,200493,297641,32.64,67.36,36.94,129793,228296,358089,36.25,63.75,32.04
2016,"AL-06",88532,234087,322619,27.44,72.56,47.34,119055,248483,367538,32.39,67.61,39.76
2016,"AL-07",200441,83132,283573,70.68,29.32,-39.14,208736,84489,293225,71.19,28.81,-37.84
2018,"AL-01",103130,192414,295544,34.89,65.11,32.44,116897,211122,328019,35.64,64.36,33.26
2018,"AL-02",96264,185808,282072,34.13,65.87,33.96,109589,196467,306056,35.81,64.19,32.92
2018,"AL-03",93307,188299,281606,33.13,66.87,35.96,108753,211580,320333,33.95,66.05,36.64
2018,"AL-04",50774,234353,285127,17.81,82.19,66.6,56781,260687,317468,17.89,82.11,68.76
2018,"AL-05",97148,200493,297641,32.64,67.36,36.94,129793,228296,358089,36.25,63.75,32.04
2018,"AL-06",88545,234131,322676,27.44,72.56,47.34,119076,248530,367606,32.39,67.61,39.76
2018,"AL-07",200441,83131,283572,70.68,29.32,-39.14,208735,84488,293223,71.19,28.81,-37.84
2020,"AL-01",103130,192414,295544,34.89,65.11,32.44,116897,211122,328019,35.64,64.36,33.26
2020,"AL-02",96247,185771,282018,34.13,65.87,33.96,109570,196432,306002,35.81,64.19,32.92
2020,"AL-03",93324,188336,281660,33.13,66.87,35.96,108772,211615,320387,33.95,66.05,36.64
2020,"AL-04",50773,234345,285118,17.81,82.19,66.6,56781,260678,317459,17.89,82.11,68.76
2020,"AL-05",97148,200493,297641,32.64,67.36,36.94,129793,228296,358089,36.25,63.75,32.04
2020,"AL-06",88524,234147,322671,27.43,72.57,47.36,119062,248548,367610,32.39,67.61,39.76
2020,"AL-07",200463,83123,283586,70.69,29.31,-39.16,208749,84479,293228,71.19,28.81,-37.84
2022,"AL-01",101869,189567,291436,34.95,65.05,32.32,115595,208153,323748,35.71,64.29,33.12
2022,"AL-02",96571,193921,290492,33.24,66.76,35.74,111145,205384,316529,35.11,64.89,34.32
2022,"AL-03",88863,187588,276451,32.14,67.86,37.94,102761,210774,313535,32.77,67.23,39
2022,"AL-04",53801,235524,289325,18.6,81.4,65.02,60776,262451,323227,18.8,81.2,66.94
2022,"AL-05",91741,189957,281698,32.57,67.43,37.08,123065,216646,339711,36.23,63.77,32.08
2022,"AL-06",91580,215075,306655,29.86,70.14,42.5,121821,228604,350425,34.76,65.24,35.02
2022,"AL-07",205182,106997,312179,65.73,34.27,-29.24,214461,109157,323618,66.27,33.73,-28
2008,"AK-01",116454,163387,279841,41.61,58.39,19,153778,189951,343729,44.74,55.26,15.06
2010,"AK-01",116454,163387,279841,41.61,58.39,19,153778,189951,343729,44.74,55.26,15.06
2012,"AK-01",116454,163387,279841,41.61,58.39,19,153778,189951,343729,44.74,55.26,15.06
2014,"AK-01",116454,163387,279841,41.61,58.39,19,153778,189951,343729,44.74,55.26,15.06
2016,"AK-01",116454,163387,279841,41.61,58.39,19,153778,189951,343729,44.74,55.26,15.06
2018,"AK-01",116440,163379,279819,41.61,58.39,19,153760,189939,343699,44.74,55.26,15.06
2020,"AK-01",116440,163379,279819,41.61,58.39,19,153760,189939,343699,44.74,55.26,15.06
2022,"AK-01",116440,163379,279819,41.61,58.39,19,153760,189939,343699,44.74,55.26,15.06
2008,"AZ-01",128068,169131,297199,43.09,56.91,16.04,176302,223097,399399,44.14,55.86,16.26
2008,"AZ-02",151662,254864,406526,37.31,62.69,27.6,231651,347283,578934,40.01,59.99,24.52
2008,"AZ-03",136543,157381,293924,46.46,53.54,9.3,196121,198254,394375,49.73,50.27,5.08000000000001
2008,"AZ-04",119053,36267,155320,76.65,23.35,-51.08,167984,54438,222422,75.52,24.48,-46.5
2008,"AZ-05",149907,138992,288899,51.89,48.11,-1.56,214117,174558,388675,55.09,44.91,-5.63999999999999
2008,"AZ-06",155731,238267,393998,39.53,60.47,23.16,250029,331800,581829,42.97,57.03,18.6
2008,"AZ-07",149888,85261,235149,63.74,36.26,-25.26,201547,122728,324275,62.15,37.85,-19.76
2008,"AZ-08",170280,172201,342481,49.72,50.28,2.78,234359,209494,443853,52.8,47.2,-1.06
2010,"AZ-01",128068,169131,297199,43.09,56.91,16.04,176302,223097,399399,44.14,55.86,16.26
2010,"AZ-02",151662,254864,406526,37.31,62.69,27.6,231651,347283,578934,40.01,59.99,24.52
2010,"AZ-03",136543,157381,293924,46.46,53.54,9.3,196121,198254,394375,49.73,50.27,5.08000000000001
2010,"AZ-04",119053,36267,155320,76.65,23.35,-51.08,167984,54438,222422,75.52,24.48,-46.5
2010,"AZ-05",149907,138992,288899,51.89,48.11,-1.56,214117,174558,388675,55.09,44.91,-5.63999999999999
2010,"AZ-06",155731,238267,393998,39.53,60.47,23.16,250029,331800,581829,42.97,57.03,18.6
2010,"AZ-07",149888,85261,235149,63.74,36.26,-25.26,201547,122728,324275,62.15,37.85,-19.76
2010,"AZ-08",170280,172201,342481,49.72,50.28,2.78,234359,209494,443853,52.8,47.2,-1.06
2012,"AZ-01",132990,136042,269032,49.43,50.57,3.36000000000001,187343,180818,368161,50.89,49.11,2.76000000000001
2012,"AZ-02",156705,141229,297934,52.6,47.4,-2.98,213439,171834,385273,55.4,44.6,-6.26
2012,"AZ-03",130377,67903,198280,65.75,34.25,-29.28,174766,99473,274239,63.73,36.27,-22.92
2012,"AZ-04",82201,202054,284255,28.92,71.08,44.38,126057,280165,406222,31.03,68.97,42.48
2012,"AZ-05",121242,191375,312617,38.78,61.22,24.66,195198,262709,457907,42.63,57.37,19.28
2012,"AZ-06",143539,177276,320815,44.74,55.26,12.74,204325,222108,426433,47.91,52.09,8.72000000000001
2012,"AZ-07",118070,37355,155425,75.97,24.03,-49.72,165313,55605,220918,74.83,25.17,-45.12
2012,"AZ-08",121096,190257,311353,38.89,61.11,24.44,181828,251551,433379,41.96,58.04,20.62
2012,"AZ-09",154942,108899,263841,58.73,41.27,-15.24,223868,137411,361279,61.97,38.03,-19.4
2014,"AZ-01",132990,136042,269032,49.43,50.57,3.36000000000001,187343,180818,368161,50.89,49.11,2.76000000000001
2014,"AZ-02",156705,141229,297934,52.6,47.4,-2.98,213439,171834,385273,55.4,44.6,-6.26
2014,"AZ-03",130377,67903,198280,65.75,34.25,-29.28,174766,99473,274239,63.73,36.27,-22.92
2014,"AZ-04",82201,202054,284255,28.92,71.08,44.38,126057,280165,406222,31.03,68.97,42.48
2014,"AZ-05",121242,191375,312617,38.78,61.22,24.66,195198,262709,457907,42.63,57.37,19.28
2014,"AZ-06",143539,177276,320815,44.74,55.26,12.74,204325,222108,426433,47.91,52.09,8.72000000000001
2014,"AZ-07",118070,37355,155425,75.97,24.03,-49.72,165313,55605,220918,74.83,25.17,-45.12
2014,"AZ-08",121096,190257,311353,38.89,61.11,24.44,181828,251551,433379,41.96,58.04,20.62
2014,"AZ-09",154942,108899,263841,58.73,41.27,-15.24,223868,137411,361279,61.97,38.03,-19.4
2016,"AZ-01",132983,136039,269022,49.43,50.57,3.36000000000001,187336,180814,368150,50.89,49.11,2.76000000000001
2016,"AZ-02",156717,141231,297948,52.6,47.4,-2.98,213455,171838,385293,55.4,44.6,-6.26
2016,"AZ-03",130365,67901,198266,65.75,34.25,-29.28,174750,99469,274219,63.73,36.27,-22.92
2016,"AZ-04",82208,202057,284265,28.92,71.08,44.38,126064,280169,406233,31.03,68.97,42.48
2016,"AZ-05",121234,191359,312593,38.78,61.22,24.66,195166,262660,457826,42.63,57.37,19.28
2016,"AZ-06",143624,177372,320996,44.74,55.26,12.74,204483,222257,426740,47.92,52.08,8.70000000000001
2016,"AZ-07",118070,37355,155425,75.97,24.03,-49.72,165313,55605,220918,74.83,25.17,-45.12
2016,"AZ-08",121096,190257,311353,38.89,61.11,24.44,181828,251551,433379,41.96,58.04,20.62
2016,"AZ-09",154865,108819,263684,58.73,41.27,-15.24,223742,137311,361053,61.97,38.03,-19.4
2018,"AZ-01",132976,136031,269007,49.43,50.57,3.36000000000001,187327,180805,368132,50.89,49.11,2.76000000000001
2018,"AZ-02",156724,141239,297963,52.6,47.4,-2.98,213464,171847,385311,55.4,44.6,-6.26
2018,"AZ-03",130418,67935,198353,65.75,34.25,-29.28,174822,99515,274337,63.73,36.27,-22.92
2018,"AZ-04",82208,202057,284265,28.92,71.08,44.38,126064,280169,406233,31.03,68.97,42.48
2018,"AZ-05",121234,191359,312593,38.78,61.22,24.66,195166,262660,457826,42.63,57.37,19.28
2018,"AZ-06",143632,177386,321018,44.74,55.26,12.74,204494,222275,426769,47.92,52.08,8.70000000000001
2018,"AZ-07",117954,37239,155193,76,24,-49.78,165141,55458,220599,74.86,25.14,-45.18
2018,"AZ-08",121043,190223,311266,38.89,61.11,24.44,181756,251505,433261,41.95,58.05,20.64
2018,"AZ-09",154973,108922,263895,58.73,41.27,-15.24,223927,137462,361389,61.96,38.04,-19.38
2020,"AZ-01",132876,135908,268784,49.44,50.56,3.34,187175,180662,367837,50.89,49.11,2.76000000000001
2020,"AZ-02",156667,141183,297850,52.6,47.4,-2.98,213385,171779,385164,55.4,44.6,-6.26
2020,"AZ-03",130553,68106,198659,65.72,34.28,-29.22,175025,99704,274729,63.71,36.29,-22.88
2020,"AZ-04",82197,202036,284233,28.92,71.08,44.38,126028,280113,406141,31.03,68.97,42.48
2020,"AZ-05",121229,191359,312588,38.78,61.22,24.66,195180,262691,457871,42.63,57.37,19.28
2020,"AZ-06",143643,177403,321046,44.74,55.26,12.74,204508,222295,426803,47.92,52.08,8.70000000000001
2020,"AZ-07",117931,37227,155158,76.01,23.99,-49.8,165117,55448,220565,74.86,25.14,-45.18
2020,"AZ-08",121064,190239,311303,38.89,61.11,24.44,181784,251526,433310,41.95,58.05,20.64
2020,"AZ-09",154965,108914,263879,58.73,41.27,-15.24,223915,137453,361368,61.96,38.04,-19.38
2022,"AZ-01",165544,180948,346492,47.78,52.22,6.66,231757,224712,456469,50.77,49.23,3.00000000000001
2022,"AZ-02",131881,165598,297479,44.33,55.67,13.56,186108,220185,406293,45.81,54.19,12.92
2022,"AZ-03",121013,36313,157326,76.92,23.08,-51.62,171123,54887,226010,75.71,24.29,-46.88
2022,"AZ-04",134713,127008,261721,51.47,48.53,-0.720000000000006,199537,161061,360598,55.34,44.66,-6.14
2022,"AZ-05",103778,165497,269275,38.54,61.46,25.14,170717,237511,408228,41.82,58.18,20.9
2022,"AZ-06",153494,170991,324485,47.3,52.7,7.62,212561,211232,423793,50.16,49.84,4.22000000000001
2022,"AZ-07",150822,72827,223649,67.44,32.56,-32.66,195963,100138,296101,66.18,33.82,-27.82
2022,"AZ-08",117046,175524,292570,40.01,59.99,22.2,171809,225347,397156,43.26,56.74,18.02
2022,"AZ-09",82834,157672,240506,34.44,65.56,33.34,132569,226627,359196,36.91,63.09,30.72
2008,"AR-01",72493,163316,235809,30.74,69.26,40.74,70261,181164,251425,27.95,72.05,48.64
2008,"AR-02",129361,165381,294742,43.89,56.11,14.44,148834,182271,331105,44.95,55.05,14.64
2008,"AR-03",96944,207694,304638,31.82,68.18,38.58,125756,237668,363424,34.6,65.4,35.34
2008,"AR-04",81614,148381,229995,35.49,64.51,31.24,79002,159441,238443,33.13,66.87,38.28
2010,"AR-01",72493,163316,235809,30.74,69.26,40.74,70261,181164,251425,27.95,72.05,48.64
2010,"AR-02",129361,165381,294742,43.89,56.11,14.44,148834,182271,331105,44.95,55.05,14.64
2010,"AR-03",96944,207694,304638,31.82,68.18,38.58,125756,237668,363424,34.6,65.4,35.34
2010,"AR-04",81614,148381,229995,35.49,64.51,31.24,79002,159441,238443,33.13,66.87,38.28
2012,"AR-01",78612,169354,247966,31.7,68.3,38.82,75810,187480,263290,28.79,71.21,46.96
2012,"AR-02",127884,160784,288668,44.3,55.7,13.62,147553,177056,324609,45.46,54.54,13.62
2012,"AR-03",89073,180912,269985,32.99,67.01,36.24,118132,207769,325901,36.25,63.75,32.04
2012,"AR-04",84841,173722,258563,32.81,67.19,36.6,82358,188240,270598,30.44,69.56,43.66
2014,"AR-01",78612,169354,247966,31.7,68.3,38.82,75810,187480,263290,28.79,71.21,46.96
2014,"AR-02",127884,160784,288668,44.3,55.7,13.62,147553,177056,324609,45.46,54.54,13.62
2014,"AR-03",89075,180915,269990,32.99,67.01,36.24,118136,207772,325908,36.25,63.75,32.04
2014,"AR-04",84841,173722,258563,32.81,67.19,36.6,82358,188240,270598,30.44,69.56,43.66
2016,"AR-01",78612,169354,247966,31.7,68.3,38.82,75810,187480,263290,28.79,71.21,46.96
2016,"AR-02",127884,160784,288668,44.3,55.7,13.62,147553,177056,324609,45.46,54.54,13.62
2016,"AR-03",89078,180921,269999,32.99,67.01,36.24,118139,207779,325918,36.25,63.75,32.04
2016,"AR-04",84838,173716,258554,32.81,67.19,36.6,82355,188233,270588,30.44,69.56,43.66
2018,"AR-01",78612,169354,247966,31.7,68.3,38.82,75810,187480,263290,28.79,71.21,46.96
2018,"AR-02",127884,160784,288668,44.3,55.7,13.62,147553,177056,324609,45.46,54.54,13.62
2018,"AR-03",89078,180924,270002,32.99,67.01,36.24,118139,207782,325921,36.25,63.75,32.04
2018,"AR-04",84838,173713,258551,32.81,67.19,36.6,82355,188230,270585,30.44,69.56,43.66
2020,"AR-01",78649,169424,248073,31.7,68.3,38.82,75837,187544,263381,28.79,71.21,46.96
2020,"AR-02",127883,160782,288665,44.3,55.7,13.62,147552,177053,324605,45.46,54.54,13.62
2020,"AR-03",89080,180932,270012,32.99,67.01,36.24,118141,207794,325935,36.25,63.75,32.04
2020,"AR-04",84836,173705,258541,32.81,67.19,36.6,82353,188219,270572,30.44,69.56,43.66
2022,"AR-01",82717,178618,261335,31.65,68.35,38.92,80476,197806,278282,28.92,71.08,46.7
2022,"AR-02",120850,166864,287714,42,58,18.22,140255,183965,324220,43.26,56.74,18.02
2022,"AR-03",82469,156664,239133,34.49,65.51,33.24,110473,180782,291255,37.93,62.07,28.68
2022,"AR-04",94412,182697,277109,34.07,65.93,34.08,92679,198057,290736,31.88,68.12,40.78
2008,"CA-01",184567,88230,272797,67.66,32.34,-33.1,235912,109047,344959,68.39,31.61,-32.24
2008,"CA-02",105536,161625,267161,39.5,60.5,23.22,136044,191216,327260,41.57,58.43,21.4
2008,"CA-03",168123,154986,323109,52.03,47.97,-1.84,231729,204205,435934,53.16,46.84,-1.77999999999999
2008,"CA-04",153969,202255,356224,43.22,56.78,15.78,218773,253310,472083,46.34,53.66,11.86
2008,"CA-05",170049,54556,224605,75.71,24.29,-49.2,224206,79384,303590,73.85,26.15,-43.16
2008,"CA-06",244740,63839,308579,79.31,20.69,-56.4,298150,75420,373570,79.81,20.19,-55.08
2008,"CA-07",180910,58581,239491,75.54,24.46,-48.86,230110,80837,310947,74,26,-43.46
2008,"CA-08",286036,27637,313673,91.19,8.81,-80.16,311558,42895,354453,87.9,12.1,-71.26
2008,"CA-09",266838,21802,288640,92.45,7.55,-82.68,306070,31598,337668,90.64,9.36,-76.74
2008,"CA-10",216692,90281,306973,70.59,29.41,-38.96,284752,116955,401707,70.89,29.11,-37.24
2008,"CA-11",177743,130762,308505,57.61,42.39,-13,244592,170422,415014,58.94,41.06,-13.34
2008,"CA-12",228346,53508,281854,81.02,18.98,-59.82,274316,71335,345651,79.36,20.64,-54.18
2008,"CA-13",190097,44380,234477,81.07,18.93,-59.92,232382,67594,299976,77.47,22.53,-50.4
2008,"CA-14",224688,52725,277413,80.99,19.01,-59.76,270461,65020,335481,80.62,19.38,-56.7
2008,"CA-15",188170,59675,247845,75.92,24.08,-49.62,230447,85137,315584,73.02,26.98,-41.5
2008,"CA-16",181741,48589,230330,78.9,21.1,-55.58,217550,83278,300828,72.32,27.68,-40.1
2008,"CA-17",169492,56014,225506,75.16,24.84,-48.1,211290,73121,284411,74.29,25.71,-44.04
2008,"CA-18",112531,67401,179932,62.54,37.46,-22.86,142352,94332,236684,60.14,39.86,-15.74
2008,"CA-19",119601,136758,256359,46.65,53.35,8.91999999999999,160351,172736,333087,48.14,51.86,8.26
2008,"CA-20",84174,45136,129310,65.09,34.91,-27.96,105741,66768,172509,61.3,38.7,-18.06
2008,"CA-21",99229,123439,222668,44.56,55.44,13.1,142292,165432,307724,46.24,53.76,12.06
2008,"CA-22",112003,166840,278843,40.17,59.83,21.88,156581,205079,361660,43.3,56.7,17.94
2008,"CA-23",179272,72430,251702,71.22,28.78,-40.22,218932,89449,308381,70.99,29.01,-37.44
2008,"CA-24",160825,138131,298956,53.8,46.2,-5.38,212060,164667,376727,56.29,43.71,-8.03999999999998
2008,"CA-25",147323,126641,273964,53.77,46.23,-5.32,201171,162781,363952,55.27,44.73,-5.99999999999999
2008,"CA-26",153531,117139,270670,56.72,43.28,-11.22,206627,151935,358562,57.63,42.37,-10.72
2008,"CA-27",174019,64300,238319,73.02,26.98,-43.82,215987,96457,312444,69.13,30.87,-33.72
2008,"CA-28",166799,35112,201911,82.61,17.39,-63,202659,60581,263240,76.99,23.01,-49.44
2008,"CA-29",165357,59220,224577,73.63,26.37,-45.04,209833,89912,299745,70,30,-35.46
2008,"CA-30",241603,73963,315566,76.56,23.44,-50.9,279547,103231,382778,73.03,26.97,-41.52
2008,"CA-31",140728,17180,157908,89.12,10.88,-76.02,170955,32797,203752,83.9,16.1,-63.26
2008,"CA-32",130348,39426,169774,76.78,23.22,-51.34,163135,67883,231018,70.62,29.38,-36.7
2008,"CA-33",209639,21566,231205,90.67,9.33,-79.12,245955,37883,283838,86.65,13.35,-68.76
2008,"CA-34",132107,24238,156345,84.5,15.5,-66.78,158488,45954,204442,77.52,22.48,-50.5
2008,"CA-35",171326,21100,192426,89.03,10.97,-75.84,203750,38454,242204,84.12,15.88,-63.7
2008,"CA-36",183146,71261,254407,71.99,28.01,-41.76,230749,93144,323893,71.24,28.76,-37.94
2008,"CA-37",162954,29876,192830,84.51,15.49,-66.8,193245,49002,242247,79.77,20.23,-55
2008,"CA-38",143892,37360,181252,79.39,20.61,-56.56,173017,64291,237308,72.91,27.09,-41.28
2008,"CA-39",142576,48931,191507,74.45,25.55,-46.68,172676,74958,247634,69.73,30.27,-34.92
2008,"CA-40",126917,104141,231058,54.93,45.07,-7.64,167363,137790,305153,54.85,45.15,-5.16
2008,"CA-41",120773,150785,271558,44.47,55.53,13.28,168156,190549,358705,46.88,53.12,10.78
2008,"CA-42",135899,136918,272817,49.81,50.19,2.59999999999999,188204,174832,363036,51.84,48.16,0.860000000000007
2008,"CA-43",130271,46525,176796,73.68,26.32,-45.14,167999,78803,246802,68.07,31.93,-31.6
2008,"CA-44",148798,134995,283793,52.43,47.57,-2.64,208725,184202,392927,53.12,46.88,-1.69999999999999
2008,"CA-45",162895,135056,297951,54.67,45.33,-7.12,229226,175916,405142,56.58,43.42,-8.62
2008,"CA-46",151523,129373,280896,53.94,46.06,-5.66,201992,171325,373317,54.11,45.89,-3.67999999999999
2008,"CA-47",103987,36346,140333,74.1,25.9,-45.98,126075,68805,194880,64.69,35.31,-24.84
2008,"CA-48",174482,144169,318651,54.76,45.24,-7.3,243042,182538,425580,57.11,42.89,-9.68
2008,"CA-49",133493,144596,278089,48,52,6.22,192851,186844,379695,50.79,49.21,2.96000000000001
2008,"CA-50",193597,138569,332166,58.28,41.72,-14.34,266028,167030,433058,61.43,38.57,-18.32
2008,"CA-51",177496,65570,243066,73.02,26.98,-43.82,209763,104739,314502,66.7,33.3,-28.86
2008,"CA-52",138367,146895,285262,48.51,51.49,5.2,193505,177755,371260,52.12,47.88,0.300000000000011
2008,"CA-53",182839,62466,245305,74.54,25.46,-46.86,222906,76673,299579,74.41,25.59,-44.28
2010,"CA-01",184567,88230,272797,67.66,32.34,-33.1,235912,109047,344959,68.39,31.61,-32.24
2010,"CA-02",105536,161625,267161,39.5,60.5,23.22,136044,191216,327260,41.57,58.43,21.4
2010,"CA-03",168123,154986,323109,52.03,47.97,-1.84,231729,204205,435934,53.16,46.84,-1.77999999999999
2010,"CA-04",153969,202255,356224,43.22,56.78,15.78,218773,253310,472083,46.34,53.66,11.86
2010,"CA-05",170049,54556,224605,75.71,24.29,-49.2,224206,79384,303590,73.85,26.15,-43.16
2010,"CA-06",244740,63839,308579,79.31,20.69,-56.4,298150,75420,373570,79.81,20.19,-55.08
2010,"CA-07",180910,58581,239491,75.54,24.46,-48.86,230110,80837,310947,74,26,-43.46
2010,"CA-08",286036,27637,313673,91.19,8.81,-80.16,311558,42895,354453,87.9,12.1,-71.26
2010,"CA-09",266838,21802,288640,92.45,7.55,-82.68,306070,31598,337668,90.64,9.36,-76.74
2010,"CA-10",216692,90281,306973,70.59,29.41,-38.96,284752,116955,401707,70.89,29.11,-37.24
2010,"CA-11",177743,130762,308505,57.61,42.39,-13,244592,170422,415014,58.94,41.06,-13.34
2010,"CA-12",228346,53508,281854,81.02,18.98,-59.82,274316,71335,345651,79.36,20.64,-54.18
2010,"CA-13",190097,44380,234477,81.07,18.93,-59.92,232382,67594,299976,77.47,22.53,-50.4
2010,"CA-14",224688,52725,277413,80.99,19.01,-59.76,270461,65020,335481,80.62,19.38,-56.7
2010,"CA-15",188170,59675,247845,75.92,24.08,-49.62,230447,85137,315584,73.02,26.98,-41.5
2010,"CA-16",181741,48589,230330,78.9,21.1,-55.58,217550,83278,300828,72.32,27.68,-40.1
2010,"CA-17",169492,56014,225506,75.16,24.84,-48.1,211290,73121,284411,74.29,25.71,-44.04
2010,"CA-18",112531,67401,179932,62.54,37.46,-22.86,142352,94332,236684,60.14,39.86,-15.74
2010,"CA-19",119601,136758,256359,46.65,53.35,8.91999999999999,160351,172736,333087,48.14,51.86,8.26
2010,"CA-20",84174,45136,129310,65.09,34.91,-27.96,105741,66768,172509,61.3,38.7,-18.06
2010,"CA-21",99229,123439,222668,44.56,55.44,13.1,142292,165432,307724,46.24,53.76,12.06
2010,"CA-22",112003,166840,278843,40.17,59.83,21.88,156581,205079,361660,43.3,56.7,17.94
2010,"CA-23",179272,72430,251702,71.22,28.78,-40.22,218932,89449,308381,70.99,29.01,-37.44
2010,"CA-24",160825,138131,298956,53.8,46.2,-5.38,212060,164667,376727,56.29,43.71,-8.03999999999998
2010,"CA-25",147323,126641,273964,53.77,46.23,-5.32,201171,162781,363952,55.27,44.73,-5.99999999999999
2010,"CA-26",153531,117139,270670,56.72,43.28,-11.22,206627,151935,358562,57.63,42.37,-10.72
2010,"CA-27",174019,64300,238319,73.02,26.98,-43.82,215987,96457,312444,69.13,30.87,-33.72
2010,"CA-28",166799,35112,201911,82.61,17.39,-63,202659,60581,263240,76.99,23.01,-49.44
2010,"CA-29",165357,59220,224577,73.63,26.37,-45.04,209833,89912,299745,70,30,-35.46
2010,"CA-30",241603,73963,315566,76.56,23.44,-50.9,279547,103231,382778,73.03,26.97,-41.52
2010,"CA-31",140728,17180,157908,89.12,10.88,-76.02,170955,32797,203752,83.9,16.1,-63.26
2010,"CA-32",130348,39426,169774,76.78,23.22,-51.34,163135,67883,231018,70.62,29.38,-36.7
2010,"CA-33",209639,21566,231205,90.67,9.33,-79.12,245955,37883,283838,86.65,13.35,-68.76
2010,"CA-34",132107,24238,156345,84.5,15.5,-66.78,158488,45954,204442,77.52,22.48,-50.5
2010,"CA-35",171326,21100,192426,89.03,10.97,-75.84,203750,38454,242204,84.12,15.88,-63.7
2010,"CA-36",183146,71261,254407,71.99,28.01,-41.76,230749,93144,323893,71.24,28.76,-37.94
2010,"CA-37",162954,29876,192830,84.51,15.49,-66.8,193245,49002,242247,79.77,20.23,-55
2010,"CA-38",143892,37360,181252,79.39,20.61,-56.56,173017,64291,237308,72.91,27.09,-41.28
2010,"CA-39",142576,48931,191507,74.45,25.55,-46.68,172676,74958,247634,69.73,30.27,-34.92
2010,"CA-40",126917,104141,231058,54.93,45.07,-7.64,167363,137790,305153,54.85,45.15,-5.16
2010,"CA-41",120773,150785,271558,44.47,55.53,13.28,168156,190549,358705,46.88,53.12,10.78
2010,"CA-42",135899,136918,272817,49.81,50.19,2.59999999999999,188204,174832,363036,51.84,48.16,0.860000000000007
2010,"CA-43",130271,46525,176796,73.68,26.32,-45.14,167999,78803,246802,68.07,31.93,-31.6
2010,"CA-44",148798,134995,283793,52.43,47.57,-2.64,208725,184202,392927,53.12,46.88,-1.69999999999999
2010,"CA-45",162895,135056,297951,54.67,45.33,-7.12,229226,175916,405142,56.58,43.42,-8.62
2010,"CA-46",151523,129373,280896,53.94,46.06,-5.66,201992,171325,373317,54.11,45.89,-3.67999999999999
2010,"CA-47",103987,36346,140333,74.1,25.9,-45.98,126075,68805,194880,64.69,35.31,-24.84
2010,"CA-48",174482,144169,318651,54.76,45.24,-7.3,243042,182538,425580,57.11,42.89,-9.68
2010,"CA-49",133493,144596,278089,48,52,6.22,192851,186844,379695,50.79,49.21,2.96000000000001
2010,"CA-50",193597,138569,332166,58.28,41.72,-14.34,266028,167030,433058,61.43,38.57,-18.32
2010,"CA-51",177496,65570,243066,73.02,26.98,-43.82,209763,104739,314502,66.7,33.3,-28.86
2010,"CA-52",138367,146895,285262,48.51,51.49,5.2,193505,177755,371260,52.12,47.88,0.300000000000011
2010,"CA-53",182839,62466,245305,74.54,25.46,-46.86,222906,76673,299579,74.41,25.59,-44.28
2012,"CA-01",114721,176352,291073,39.41,60.59,23.4,148764,203549,352313,42.22,57.78,20.1
2012,"CA-02",238253,80574,318827,74.73,25.27,-47.24,294400,95634,390034,75.48,24.52,-46.42
2012,"CA-03",138902,105872,244774,56.75,43.25,-11.28,180287,139970,320257,56.29,43.71,-8.03999999999998
2012,"CA-04",138745,190850,329595,42.1,57.9,18.02,197325,241087,438412,45.01,54.99,14.52
2012,"CA-05",210835,74055,284890,74.01,25.99,-45.8,264135,92070,356205,74.15,25.85,-43.76
2012,"CA-06",168666,59537,228203,73.91,26.09,-45.6,224989,87181,312170,72.07,27.93,-39.6
2012,"CA-07",159116,124331,283447,56.14,43.86,-10.06,217879,163885,381764,57.07,42.93,-9.59999999999999
2012,"CA-08",92212,127445,219657,41.98,58.02,18.26,127986,158694,286680,44.64,55.36,15.26
2012,"CA-09",134719,90479,225198,59.82,40.18,-17.42,180045,124090,304135,59.2,40.8,-13.86
2012,"CA-10",116334,109145,225479,51.59,48.41,-0.960000000000008,155003,146047,301050,51.49,48.51,1.56
2012,"CA-11",223693,70883,294576,75.94,24.06,-49.66,285238,90545,375783,75.9,24.1,-47.26
2012,"CA-12",308632,31117,339749,90.84,9.16,-79.46,337505,46573,384078,87.87,12.13,-71.2
2012,"CA-13",291722,22723,314445,92.77,7.23,-83.32,335372,33891,369263,90.82,9.18,-77.1
2012,"CA-14",229777,54316,284093,80.88,19.12,-59.54,279631,73788,353419,79.12,20.88,-53.7
2012,"CA-15",199031,68814,267845,74.31,25.69,-46.4,255492,94443,349935,73.01,26.99,-41.48
2012,"CA-16",98504,61810,160314,61.44,38.56,-20.66,129610,85823,215433,60.16,39.84,-15.78
2012,"CA-17",184247,51125,235372,78.28,21.72,-54.34,224820,79247,304067,73.94,26.06,-43.34
2012,"CA-18",246313,67800,314113,78.42,21.58,-54.62,294563,82155,376718,78.19,21.81,-51.84
2012,"CA-19",188186,55440,243626,77.24,22.76,-52.26,228261,91067,319328,71.48,28.52,-38.42
2012,"CA-20",180499,59582,240081,75.18,24.82,-48.14,226462,77958,304420,74.39,25.61,-44.24
2012,"CA-21",73760,52961,126721,58.21,41.79,-14.2,93556,74860,168416,55.55,44.45,-6.55999999999999
2012,"CA-22",102302,125098,227400,44.99,55.01,12.24,146355,163436,309791,47.24,52.76,10.06
2012,"CA-23",88310,142345,230655,38.29,61.71,25.64,125020,176351,301371,41.48,58.52,21.58
2012,"CA-24",176981,113886,290867,60.85,39.15,-19.48,221841,134814,356655,62.2,37.8,-19.86
2012,"CA-25",137533,119292,256825,53.55,46.45,-4.88,188384,153131,341515,55.16,44.84,-5.77999999999999
2012,"CA-26",169086,105266,274352,61.63,38.37,-21.04,216848,128927,345775,62.71,37.29,-20.88
2012,"CA-27",174468,74951,249419,69.95,30.05,-37.68,226722,104235,330957,68.5,31.5,-32.46
2012,"CA-28",208564,64545,273109,76.37,23.63,-50.52,252589,97082,349671,72.24,27.76,-39.94
2012,"CA-29",152456,32948,185404,82.23,17.77,-62.24,186834,59698,246532,75.78,24.22,-47.02
2012,"CA-30",209073,77665,286738,72.91,27.09,-43.6,258871,110926,369797,70,30,-35.46
2012,"CA-31",131932,83685,215617,61.19,38.81,-20.16,173846,114795,288641,60.23,39.77,-15.92
2012,"CA-32",146417,60906,207323,70.62,29.38,-39.02,185036,93167,278203,66.51,33.49,-28.48
2012,"CA-33",239831,93606,333437,71.93,28.07,-41.64,286328,120421,406749,70.39,29.61,-36.24
2012,"CA-34",154123,19771,173894,88.63,11.37,-75.04,193936,40562,234498,82.7,17.3,-60.86
2012,"CA-35",127751,50830,178581,71.54,28.46,-40.86,166311,83371,249682,66.61,33.39,-28.68
2012,"CA-36",123795,103050,226845,54.57,45.43,-6.91999999999999,173488,131226,304714,56.93,43.07,-9.31999999999999
2012,"CA-37",236605,26603,263208,89.89,10.11,-77.56,275619,45197,320816,85.91,14.09,-67.28
2012,"CA-38",166122,67967,234089,70.97,29.03,-39.72,206949,101831,308780,67.02,32.98,-29.5
2012,"CA-39",140232,116764,256996,54.57,45.43,-6.91999999999999,190003,154369,344372,55.17,44.83,-5.79999999999999
2012,"CA-40",135436,21067,156503,86.54,13.46,-70.86,156541,41854,198395,78.9,21.1,-53.26
2012,"CA-41",126197,68526,194723,64.81,35.19,-27.4,164549,96420,260969,63.05,36.95,-21.56
2012,"CA-42",111113,143187,254300,43.69,56.31,14.84,170698,198441,369139,46.24,53.76,12.06
2012,"CA-43",183356,39021,222377,82.45,17.55,-62.68,224490,61052,285542,78.62,21.38,-52.7
2012,"CA-44",164223,24255,188478,87.13,12.87,-72.04,188681,46161,234842,80.34,19.66,-56.14
2012,"CA-45",162427,144668,307095,52.89,47.11,-3.56,228675,181337,410012,55.77,44.23,-6.99999999999999
2012,"CA-46",119672,50376,170048,70.38,29.62,-38.54,150387,78396,228783,65.73,34.27,-26.92
2012,"CA-47",161729,80144,241873,66.87,33.13,-31.52,203653,115190,318843,63.87,36.13,-23.2
2012,"CA-48",152126,146657,298783,50.92,49.08,0.379999999999995,199711,193765,393476,50.76,49.24,3.02
2012,"CA-49",158729,135598,294327,53.93,46.07,-5.64,216900,166930,383830,56.51,43.49,-8.48
2012,"CA-50",115868,159820,275688,42.03,57.97,18.16,166778,195364,362142,46.05,53.95,12.44
2012,"CA-51",147626,46822,194448,75.92,24.08,-49.62,166152,76815,242967,68.38,31.62,-32.22
2012,"CA-52",191305,117040,308345,62.04,37.96,-21.86,258065,139131,397196,64.97,35.03,-25.4
2012,"CA-53",199810,91733,291543,68.54,31.46,-34.86,258838,119416,378254,68.43,31.57,-32.32
2014,"CA-01",114721,176352,291073,39.41,60.59,23.4,148764,203549,352313,42.22,57.78,20.1
2014,"CA-02",238253,80574,318827,74.73,25.27,-47.24,294400,95634,390034,75.48,24.52,-46.42
2014,"CA-03",138902,105872,244774,56.75,43.25,-11.28,180289,139970,320259,56.29,43.71,-8.03999999999998
2014,"CA-04",138745,190850,329595,42.1,57.9,18.02,197325,241087,438412,45.01,54.99,14.52
2014,"CA-05",210835,74055,284890,74.01,25.99,-45.8,264135,92070,356205,74.15,25.85,-43.76
2014,"CA-06",168666,59537,228203,73.91,26.09,-45.6,224997,87185,312182,72.07,27.93,-39.6
2014,"CA-07",159116,124331,283447,56.14,43.86,-10.06,217869,163881,381750,57.07,42.93,-9.59999999999999
2014,"CA-08",92212,127445,219657,41.98,58.02,18.26,127986,158694,286680,44.64,55.36,15.26
2014,"CA-09",134719,90479,225198,59.82,40.18,-17.42,180045,124090,304135,59.2,40.8,-13.86
2014,"CA-10",116334,109145,225479,51.59,48.41,-0.960000000000008,155003,146047,301050,51.49,48.51,1.56
2014,"CA-11",223693,70883,294576,75.94,24.06,-49.66,285238,90545,375783,75.9,24.1,-47.26
2014,"CA-12",308619,31115,339734,90.84,9.16,-79.46,337499,46571,384070,87.87,12.13,-71.2
2014,"CA-13",291722,22723,314445,92.77,7.23,-83.32,335372,33891,369263,90.82,9.18,-77.1
2014,"CA-14",229790,54318,284108,80.88,19.12,-59.54,279636,73790,353426,79.12,20.88,-53.7
2014,"CA-15",199031,68814,267845,74.31,25.69,-46.4,255492,94443,349935,73.01,26.99,-41.48
2014,"CA-16",98504,61810,160314,61.44,38.56,-20.66,129610,85823,215433,60.16,39.84,-15.78
2014,"CA-17",184247,51125,235372,78.28,21.72,-54.34,224820,79247,304067,73.94,26.06,-43.34
2014,"CA-18",246313,67800,314113,78.42,21.58,-54.62,294564,82155,376719,78.19,21.81,-51.84
2014,"CA-19",188186,55440,243626,77.24,22.76,-52.26,228261,91067,319328,71.48,28.52,-38.42
2014,"CA-20",180499,59582,240081,75.18,24.82,-48.14,226462,77958,304420,74.39,25.61,-44.24
2014,"CA-21",73760,52961,126721,58.21,41.79,-14.2,93556,74860,168416,55.55,44.45,-6.55999999999999
2014,"CA-22",102302,125098,227400,44.99,55.01,12.24,146355,163436,309791,47.24,52.76,10.06
2014,"CA-23",88317,142348,230665,38.29,61.71,25.64,125020,176351,301371,41.48,58.52,21.58
2014,"CA-24",176981,113886,290867,60.85,39.15,-19.48,221841,134814,356655,62.2,37.8,-19.86
2014,"CA-25",137526,119289,256815,53.55,46.45,-4.88,188384,153131,341515,55.16,44.84,-5.77999999999999
2014,"CA-26",169086,105266,274352,61.63,38.37,-21.04,216848,128927,345775,62.71,37.29,-20.88
2014,"CA-27",174468,74951,249419,69.95,30.05,-37.68,226722,104235,330957,68.5,31.5,-32.46
2014,"CA-28",208564,64545,273109,76.37,23.63,-50.52,252589,97082,349671,72.24,27.76,-39.94
2014,"CA-29",152456,32948,185404,82.23,17.77,-62.24,186834,59698,246532,75.78,24.22,-47.02
2014,"CA-30",209073,77665,286738,72.91,27.09,-43.6,258871,110926,369797,70,30,-35.46
2014,"CA-31",131932,83685,215617,61.19,38.81,-20.16,173846,114795,288641,60.23,39.77,-15.92
2014,"CA-32",146417,60906,207323,70.62,29.38,-39.02,185036,93167,278203,66.51,33.49,-28.48
2014,"CA-33",239831,93606,333437,71.93,28.07,-41.64,286328,120421,406749,70.39,29.61,-36.24
2014,"CA-34",154123,19771,173894,88.63,11.37,-75.04,193936,40562,234498,82.7,17.3,-60.86
2014,"CA-35",127751,50830,178581,71.54,28.46,-40.86,166311,83371,249682,66.61,33.39,-28.68
2014,"CA-36",123795,103050,226845,54.57,45.43,-6.91999999999999,173488,131226,304714,56.93,43.07,-9.31999999999999
2014,"CA-37",236605,26603,263208,89.89,10.11,-77.56,275619,45197,320816,85.91,14.09,-67.28
2014,"CA-38",166122,67967,234089,70.97,29.03,-39.72,206949,101831,308780,67.02,32.98,-29.5
2014,"CA-39",140232,116764,256996,54.57,45.43,-6.91999999999999,190003,154369,344372,55.17,44.83,-5.79999999999999
2014,"CA-40",135436,21067,156503,86.54,13.46,-70.86,156541,41854,198395,78.9,21.1,-53.26
2014,"CA-41",126197,68526,194723,64.81,35.19,-27.4,164549,96420,260969,63.05,36.95,-21.56
2014,"CA-42",111113,143187,254300,43.69,56.31,14.84,170698,198441,369139,46.24,53.76,12.06
2014,"CA-43",183356,39021,222377,82.45,17.55,-62.68,224490,61052,285542,78.62,21.38,-52.7
2014,"CA-44",164223,24255,188478,87.13,12.87,-72.04,188681,46161,234842,80.34,19.66,-56.14
2014,"CA-45",162426,144675,307101,52.89,47.11,-3.56,228746,181430,410176,55.77,44.23,-6.99999999999999
2014,"CA-46",119672,50376,170048,70.38,29.62,-38.54,150387,78396,228783,65.73,34.27,-26.92
2014,"CA-47",161729,80144,241873,66.87,33.13,-31.52,203653,115190,318843,63.87,36.13,-23.2
2014,"CA-48",152144,146671,298815,50.92,49.08,0.379999999999995,199743,193783,393526,50.76,49.24,3.02
2014,"CA-49",158712,135577,294289,53.93,46.07,-5.64,216797,166819,383616,56.51,43.49,-8.48
2014,"CA-50",115868,159820,275688,42.03,57.97,18.16,166778,195364,362142,46.05,53.95,12.44
2014,"CA-51",147626,46822,194448,75.92,24.08,-49.62,166152,76815,242967,68.38,31.62,-32.22
2014,"CA-52",191305,117040,308345,62.04,37.96,-21.86,258065,139131,397196,64.97,35.03,-25.4
2014,"CA-53",199810,91733,291543,68.54,31.46,-34.86,258838,119416,378254,68.43,31.57,-32.32
2016,"CA-01",114721,176352,291073,39.41,60.59,23.4,148764,203549,352313,42.22,57.78,20.1
2016,"CA-02",238253,80574,318827,74.73,25.27,-47.24,294400,95634,390034,75.48,24.52,-46.42
2016,"CA-03",138902,105872,244774,56.75,43.25,-11.28,180289,139970,320259,56.29,43.71,-8.03999999999998
2016,"CA-04",138745,190850,329595,42.1,57.9,18.02,197325,241087,438412,45.01,54.99,14.52
2016,"CA-05",210835,74055,284890,74.01,25.99,-45.8,264135,92070,356205,74.15,25.85,-43.76
2016,"CA-06",168666,59537,228203,73.91,26.09,-45.6,224997,87185,312182,72.07,27.93,-39.6
2016,"CA-07",159116,124331,283447,56.14,43.86,-10.06,217869,163881,381750,57.07,42.93,-9.59999999999999
2016,"CA-08",92231,127459,219690,41.98,58.02,18.26,127973,158681,286654,44.64,55.36,15.26
2016,"CA-09",134724,90492,225216,59.82,40.18,-17.42,180053,124108,304161,59.2,40.8,-13.86
2016,"CA-10",116329,109131,225460,51.6,48.4,-0.980000000000004,154994,146024,301018,51.49,48.51,1.56
2016,"CA-11",223768,70910,294678,75.94,24.06,-49.66,285092,90520,375612,75.9,24.1,-47.26
2016,"CA-12",308619,31115,339734,90.84,9.16,-79.46,337499,46571,384070,87.87,12.13,-71.2
2016,"CA-13",291722,22723,314445,92.77,7.23,-83.32,335372,33891,369263,90.82,9.18,-77.1
2016,"CA-14",229790,54318,284108,80.88,19.12,-59.54,279668,73794,353462,79.12,20.88,-53.7
2016,"CA-15",198965,68792,267757,74.31,25.69,-46.4,255638,94468,350106,73.02,26.98,-41.5
2016,"CA-16",98504,61811,160315,61.44,38.56,-20.66,129611,85828,215439,60.16,39.84,-15.78
2016,"CA-17",184240,51124,235364,78.28,21.72,-54.34,224821,79248,304069,73.94,26.06,-43.34
2016,"CA-18",246320,67801,314121,78.42,21.58,-54.62,294531,82150,376681,78.19,21.81,-51.84
2016,"CA-19",188186,55440,243626,77.24,22.76,-52.26,228261,91067,319328,71.48,28.52,-38.42
2016,"CA-20",180499,59582,240081,75.18,24.82,-48.14,226462,77958,304420,74.39,25.61,-44.24
2016,"CA-21",73760,52961,126721,58.21,41.79,-14.2,93556,74860,168416,55.55,44.45,-6.55999999999999
2016,"CA-22",102302,125098,227400,44.99,55.01,12.24,146355,163436,309791,47.24,52.76,10.06
2016,"CA-23",88317,142348,230665,38.29,61.71,25.64,125020,176351,301371,41.48,58.52,21.58
2016,"CA-24",176997,113890,290887,60.85,39.15,-19.48,221841,134814,356655,62.2,37.8,-19.86
2016,"CA-25",137526,119289,256815,53.55,46.45,-4.88,188384,153131,341515,55.16,44.84,-5.77999999999999
2016,"CA-26",169070,105262,274332,61.63,38.37,-21.04,216848,128927,345775,62.71,37.29,-20.88
2016,"CA-27",174459,74935,249394,69.95,30.05,-37.68,226704,104200,330904,68.51,31.49,-32.48
2016,"CA-28",208564,64545,273109,76.37,23.63,-50.52,252589,97082,349671,72.24,27.76,-39.94
2016,"CA-29",152456,32948,185404,82.23,17.77,-62.24,186834,59698,246532,75.78,24.22,-47.02
2016,"CA-30",209077,77667,286744,72.91,27.09,-43.6,258871,110926,369797,70,30,-35.46
2016,"CA-31",131934,83690,215624,61.19,38.81,-20.16,173877,114841,288718,60.22,39.78,-15.9
2016,"CA-32",146417,60906,207323,70.62,29.38,-39.02,185036,93167,278203,66.51,33.49,-28.48
2016,"CA-33",239827,93604,333431,71.93,28.07,-41.64,286297,120410,406707,70.39,29.61,-36.24
2016,"CA-34",154123,19771,173894,88.63,11.37,-75.04,193936,40562,234498,82.7,17.3,-60.86
2016,"CA-35",127739,50827,178566,71.54,28.46,-40.86,166311,83371,249682,66.61,33.39,-28.68
2016,"CA-36",123738,102985,226723,54.58,45.42,-6.94,173579,131316,304895,56.93,43.07,-9.31999999999999
2016,"CA-37",236605,26603,263208,89.89,10.11,-77.56,275619,45197,320816,85.91,14.09,-67.28
2016,"CA-38",166122,67967,234089,70.97,29.03,-39.72,206954,101833,308787,67.02,32.98,-29.5
2016,"CA-39",140264,116799,257063,54.56,45.44,-6.89999999999999,190022,154396,344418,55.17,44.83,-5.79999999999999
2016,"CA-40",135436,21067,156503,86.54,13.46,-70.86,156536,41853,198389,78.9,21.1,-53.26
2016,"CA-41",126209,68543,194752,64.8,35.2,-27.38,164620,96470,261090,63.05,36.95,-21.56
2016,"CA-42",111163,143238,254401,43.7,56.3,14.82,170482,198230,368712,46.24,53.76,12.06
2016,"CA-43",183356,39021,222377,82.45,17.55,-62.68,224521,61063,285584,78.62,21.38,-52.7
2016,"CA-44",164223,24255,188478,87.13,12.87,-72.04,188681,46161,234842,80.34,19.66,-56.14
2016,"CA-45",162394,144640,307034,52.89,47.11,-3.56,228727,181403,410130,55.77,44.23,-6.99999999999999
2016,"CA-46",119672,50376,170048,70.38,29.62,-38.54,150387,78396,228783,65.73,34.27,-26.92
2016,"CA-47",161788,80211,241999,66.85,33.15,-31.48,203665,115195,318860,63.87,36.13,-23.2
2016,"CA-48",152085,146604,298689,50.92,49.08,0.379999999999995,199745,193786,393531,50.76,49.24,3.02
2016,"CA-49",158712,135577,294289,53.93,46.07,-5.64,216797,166819,383616,56.51,43.49,-8.48
2016,"CA-50",115866,159821,275687,42.03,57.97,18.16,166829,195430,362259,46.05,53.95,12.44
2016,"CA-51",147626,46822,194448,75.92,24.08,-49.62,166152,76815,242967,68.38,31.62,-32.22
2016,"CA-52",191305,117040,308345,62.04,37.96,-21.86,258065,139131,397196,64.97,35.03,-25.4
2016,"CA-53",199807,91729,291536,68.54,31.46,-34.86,258842,119421,378263,68.43,31.57,-32.32
2018,"CA-01",114723,176355,291078,39.41,60.59,23.4,148764,203549,352313,42.22,57.78,20.1
2018,"CA-02",238253,80574,318827,74.73,25.27,-47.24,294400,95634,390034,75.48,24.52,-46.42
2018,"CA-03",139135,105949,245084,56.77,43.23,-11.32,180151,139925,320076,56.28,43.72,-8.01999999999999
2018,"CA-04",138745,190850,329595,42.1,57.9,18.02,197325,241087,438412,45.01,54.99,14.52
2018,"CA-05",210835,74055,284890,74.01,25.99,-45.8,264134,92069,356203,74.15,25.85,-43.76
2018,"CA-06",168493,59481,227974,73.91,26.09,-45.6,225112,87216,312328,72.08,27.92,-39.62
2018,"CA-07",159054,124307,283361,56.13,43.87,-10.04,217883,163891,381774,57.07,42.93,-9.59999999999999
2018,"CA-08",92327,127532,219859,41.99,58.01,18.24,127787,158471,286258,44.64,55.36,15.26
2018,"CA-09",134716,90487,225203,59.82,40.18,-17.42,180056,124111,304167,59.2,40.8,-13.86
2018,"CA-10",116329,109131,225460,51.6,48.4,-0.980000000000004,154994,146024,301018,51.49,48.51,1.56
2018,"CA-11",223776,70916,294692,75.94,24.06,-49.66,285090,90518,375608,75.9,24.1,-47.26
2018,"CA-12",308619,31115,339734,90.84,9.16,-79.46,337499,46571,384070,87.87,12.13,-71.2
2018,"CA-13",291708,22719,314427,92.77,7.23,-83.32,335372,33891,369263,90.82,9.18,-77.1
2018,"CA-14",229790,54318,284108,80.88,19.12,-59.54,279668,73794,353462,79.12,20.88,-53.7
2018,"CA-15",198979,68795,267774,74.31,25.69,-46.4,255638,94468,350106,73.02,26.98,-41.5
2018,"CA-16",98518,61820,160338,61.44,38.56,-20.66,129570,85774,215344,60.17,39.83,-15.8
2018,"CA-17",184234,51122,235356,78.28,21.72,-54.34,224803,79240,304043,73.94,26.06,-43.34
2018,"CA-18",246327,67804,314131,78.42,21.58,-54.62,294533,82151,376684,78.19,21.81,-51.84
2018,"CA-19",188185,55439,243624,77.24,22.76,-52.26,228277,91074,319351,71.48,28.52,-38.42
2018,"CA-20",180499,59582,240081,75.18,24.82,-48.14,226462,77958,304420,74.39,25.61,-44.24
2018,"CA-21",73760,52960,126720,58.21,41.79,-14.2,93556,74860,168416,55.55,44.45,-6.55999999999999
2018,"CA-22",102288,125089,227377,44.99,55.01,12.24,146396,163490,309886,47.24,52.76,10.06
2018,"CA-23",88317,142348,230665,38.29,61.71,25.64,125020,176351,301371,41.48,58.52,21.58
2018,"CA-24",176997,113890,290887,60.85,39.15,-19.48,221841,134814,356655,62.2,37.8,-19.86
2018,"CA-25",137526,119289,256815,53.55,46.45,-4.88,188395,153139,341534,55.16,44.84,-5.77999999999999
2018,"CA-26",169070,105262,274332,61.63,38.37,-21.04,216837,128919,345756,62.71,37.29,-20.88
2018,"CA-27",174444,74908,249352,69.96,30.04,-37.7,226696,104188,330884,68.51,31.49,-32.48
2018,"CA-28",208564,64545,273109,76.37,23.63,-50.52,252602,97084,349686,72.24,27.76,-39.94
2018,"CA-29",152456,32948,185404,82.23,17.77,-62.24,186834,59698,246532,75.78,24.22,-47.02
2018,"CA-30",209077,77667,286744,72.91,27.09,-43.6,258871,110926,369797,70,30,-35.46
2018,"CA-31",131855,83638,215493,61.19,38.81,-20.16,174057,115044,289101,60.21,39.79,-15.88
2018,"CA-32",146421,60913,207334,70.62,29.38,-39.02,185040,93170,278210,66.51,33.49,-28.48
2018,"CA-33",239833,93607,333440,71.93,28.07,-41.64,286281,120407,406688,70.39,29.61,-36.24
2018,"CA-34",154117,19770,173887,88.63,11.37,-75.04,193939,40563,234502,82.7,17.3,-60.86
2018,"CA-35",127746,50832,178578,71.54,28.46,-40.86,166316,83374,249690,66.61,33.39,-28.68
2018,"CA-36",123731,102978,226709,54.58,45.42,-6.94,173578,131314,304892,56.93,43.07,-9.31999999999999
2018,"CA-37",236605,26603,263208,89.89,10.11,-77.56,275619,45197,320816,85.91,14.09,-67.28
2018,"CA-38",166122,67967,234089,70.97,29.03,-39.72,206954,101833,308787,67.02,32.98,-29.5
2018,"CA-39",140257,116794,257051,54.56,45.44,-6.89999999999999,190018,154394,344412,55.17,44.83,-5.79999999999999
2018,"CA-40",135436,21067,156503,86.54,13.46,-70.86,156536,41853,198389,78.9,21.1,-53.26
2018,"CA-41",126214,68547,194761,64.8,35.2,-27.38,164620,96470,261090,63.05,36.95,-21.56
2018,"CA-42",111166,143240,254406,43.7,56.3,14.82,170482,198231,368713,46.24,53.76,12.06
2018,"CA-43",183350,39018,222368,82.45,17.55,-62.68,224521,61063,285584,78.62,21.38,-52.7
2018,"CA-44",164223,24255,188478,87.13,12.87,-72.04,188691,46164,234855,80.34,19.66,-56.14
2018,"CA-45",162394,144639,307033,52.89,47.11,-3.56,228727,181403,410130,55.77,44.23,-6.99999999999999
2018,"CA-46",119673,50378,170051,70.37,29.63,-38.52,150387,78396,228783,65.73,34.27,-26.92
2018,"CA-47",161799,80220,242019,66.85,33.15,-31.48,203652,115190,318842,63.87,36.13,-23.2
2018,"CA-48",152073,146594,298667,50.92,49.08,0.379999999999995,199745,193786,393531,50.76,49.24,3.02
2018,"CA-49",158716,135582,294298,53.93,46.07,-5.64,216788,166818,383606,56.51,43.49,-8.48
2018,"CA-50",115859,159812,275671,42.03,57.97,18.16,166828,195430,362258,46.05,53.95,12.44
2018,"CA-51",147620,46820,194440,75.92,24.08,-49.62,166144,76811,242955,68.38,31.62,-32.22
2018,"CA-52",191296,117032,308328,62.04,37.96,-21.86,258107,139143,397250,64.97,35.03,-25.4
2018,"CA-53",199825,91743,291568,68.53,31.47,-34.84,258818,119414,378232,68.43,31.57,-32.32
2020,"CA-01",114723,176355,291078,39.41,60.59,23.4,148764,203549,352313,42.22,57.78,20.1
2020,"CA-02",238253,80574,318827,74.73,25.27,-47.24,294400,95634,390034,75.48,24.52,-46.42
2020,"CA-03",139163,105959,245122,56.77,43.23,-11.32,179991,139851,319842,56.27,43.73,-7.99999999999999
2020,"CA-04",138750,190853,329603,42.1,57.9,18.02,197314,241072,438386,45.01,54.99,14.52
2020,"CA-05",210823,74047,284870,74.01,25.99,-45.8,264165,92081,356246,74.15,25.85,-43.76
2020,"CA-06",168471,59481,227952,73.91,26.09,-45.6,225080,87200,312280,72.08,27.92,-39.62
2020,"CA-07",159068,124310,283378,56.13,43.87,-10.04,218049,163970,382019,57.08,42.92,-9.61999999999999
2020,"CA-08",92270,127520,219790,41.98,58.02,18.26,127750,158413,286163,44.64,55.36,15.26
2020,"CA-09",134720,90494,225214,59.82,40.18,-17.42,180081,124133,304214,59.2,40.8,-13.86
2020,"CA-10",116320,109117,225437,51.6,48.4,-0.980000000000004,154980,146017,300997,51.49,48.51,1.56
2020,"CA-11",223950,70923,294873,75.95,24.05,-49.68,285137,90522,375659,75.9,24.1,-47.26
2020,"CA-12",308636,31118,339754,90.84,9.16,-79.46,337521,46575,384096,87.87,12.13,-71.2
2020,"CA-13",291494,22701,314195,92.77,7.23,-83.32,335316,33882,369198,90.82,9.18,-77.1
2020,"CA-14",229838,54329,284167,80.88,19.12,-59.54,279655,73788,353443,79.12,20.88,-53.7
2020,"CA-15",199005,68804,267809,74.31,25.69,-46.4,255641,94472,350113,73.02,26.98,-41.5
2020,"CA-16",98519,61821,160340,61.44,38.56,-20.66,129570,85774,215344,60.17,39.83,-15.8
2020,"CA-17",184276,51126,235402,78.28,21.72,-54.34,224856,79250,304106,73.94,26.06,-43.34
2020,"CA-18",246226,67781,314007,78.41,21.59,-54.6,294494,82146,376640,78.19,21.81,-51.84
2020,"CA-19",188173,55439,243612,77.24,22.76,-52.26,228257,91071,319328,71.48,28.52,-38.42
2020,"CA-20",180511,59586,240097,75.18,24.82,-48.14,226462,77958,304420,74.39,25.61,-44.24
2020,"CA-21",73759,52960,126719,58.21,41.79,-14.2,93558,74869,168427,55.55,44.45,-6.55999999999999
2020,"CA-22",102288,125089,227377,44.99,55.01,12.24,146396,163491,309887,47.24,52.76,10.06
2020,"CA-23",88315,142342,230657,38.29,61.71,25.64,125030,176365,301395,41.48,58.52,21.58
2020,"CA-24",176997,113890,290887,60.85,39.15,-19.48,221842,134815,356657,62.2,37.8,-19.86
2020,"CA-25",137540,119296,256836,53.55,46.45,-4.88,188395,153139,341534,55.16,44.84,-5.77999999999999
2020,"CA-26",169074,105264,274338,61.63,38.37,-21.04,216837,128919,345756,62.71,37.29,-20.88
2020,"CA-27",174419,74905,249324,69.96,30.04,-37.7,226662,104154,330816,68.52,31.48,-32.5
2020,"CA-28",208558,64543,273101,76.37,23.63,-50.52,252602,97084,349686,72.24,27.76,-39.94
2020,"CA-29",152456,32948,185404,82.23,17.77,-62.24,186834,59698,246532,75.78,24.22,-47.02
2020,"CA-30",209059,77657,286716,72.92,27.08,-43.62,258866,110922,369788,70,30,-35.46
2020,"CA-31",131915,83657,215572,61.19,38.81,-20.16,174084,115115,289199,60.2,39.8,-15.86
2020,"CA-32",146407,60900,207307,70.62,29.38,-39.02,185025,93154,278179,66.51,33.49,-28.48
2020,"CA-33",239850,93610,333460,71.93,28.07,-41.64,286269,120409,406678,70.39,29.61,-36.24
2020,"CA-34",154123,19772,173895,88.63,11.37,-75.04,193939,40563,234502,82.7,17.3,-60.86
2020,"CA-35",127763,50831,178594,71.54,28.46,-40.86,166349,83373,249722,66.61,33.39,-28.68
2020,"CA-36",123731,102978,226709,54.58,45.42,-6.94,173578,131314,304892,56.93,43.07,-9.31999999999999
2020,"CA-37",236588,26601,263189,89.89,10.11,-77.56,275636,45199,320835,85.91,14.09,-67.28
2020,"CA-38",166120,67967,234087,70.97,29.03,-39.72,206923,101824,308747,67.02,32.98,-29.5
2020,"CA-39",140264,116804,257068,54.56,45.44,-6.89999999999999,190048,154420,344468,55.17,44.83,-5.79999999999999
2020,"CA-40",135423,21065,156488,86.54,13.46,-70.86,156524,41849,198373,78.9,21.1,-53.26
2020,"CA-41",126214,68546,194760,64.8,35.2,-27.38,164622,96473,261095,63.05,36.95,-21.56
2020,"CA-42",111166,143241,254407,43.7,56.3,14.82,170480,198228,368708,46.24,53.76,12.06
2020,"CA-43",183350,39018,222368,82.45,17.55,-62.68,224521,61063,285584,78.62,21.38,-52.7
2020,"CA-44",164243,24258,188501,87.13,12.87,-72.04,188716,46170,234886,80.34,19.66,-56.14
2020,"CA-45",162392,144636,307028,52.89,47.11,-3.56,228770,181427,410197,55.77,44.23,-6.99999999999999
2020,"CA-46",119656,50372,170028,70.37,29.63,-38.52,150382,78396,228778,65.73,34.27,-26.92
2020,"CA-47",161821,80246,242067,66.85,33.15,-31.48,203676,115209,318885,63.87,36.13,-23.2
2020,"CA-48",152058,146572,298630,50.92,49.08,0.379999999999995,199704,193757,393461,50.76,49.24,3.02
2020,"CA-49",158716,135583,294299,53.93,46.07,-5.64,216770,166807,383577,56.51,43.49,-8.48
2020,"CA-50",115857,159812,275669,42.03,57.97,18.16,166837,195433,362270,46.05,53.95,12.44
2020,"CA-51",147569,46806,194375,75.92,24.08,-49.62,166148,76816,242964,68.38,31.62,-32.22
2020,"CA-52",191294,117026,308320,62.04,37.96,-21.86,258087,139124,397211,64.97,35.03,-25.4
2020,"CA-53",199841,91758,291599,68.53,31.47,-34.84,258836,119431,378267,68.43,31.57,-32.32
2022,"CA-01",105844,170704,276548,38.27,61.73,25.68,136860,203070,339930,40.26,59.74,24.02
2022,"CA-02",250837,85328,336165,74.62,25.38,-47.02,310148,101416,411564,75.36,24.64,-46.18
2022,"CA-03",148627,176191,324818,45.76,54.24,10.7,212390,220602,432992,49.05,50.95,6.44
2022,"CA-04",199860,92046,291906,68.47,31.53,-34.72,250728,113972,364700,68.75,31.25,-32.96
2022,"CA-05",127613,177509,305122,41.82,58.18,18.58,172094,222490,394584,43.61,56.39,17.32
2022,"CA-06",140255,97274,237529,59.05,40.95,-15.88,193783,131905,325688,59.5,40.5,-14.46
2022,"CA-07",172889,72153,245042,70.55,29.45,-38.88,227875,102066,329941,69.07,30.93,-33.6
2022,"CA-08",191964,49519,241483,79.49,20.51,-56.76,243719,70379,314098,77.59,22.41,-50.64
2022,"CA-09",118799,90160,208959,56.85,43.15,-11.48,157779,122211,279990,56.35,43.65,-8.16
2022,"CA-10",211116,93575,304691,69.29,30.71,-36.36,280941,119840,400781,70.1,29.9,-35.66
2022,"CA-11",312213,32222,344435,90.64,9.36,-79.06,339712,46178,385890,88.03,11.97,-71.52
2022,"CA-12",286432,21291,307723,93.08,6.92,-83.94,328622,31723,360345,91.2,8.8,-77.86
2022,"CA-13",94642,71327,165969,57.02,42.98,-11.82,124955,99424,224379,55.69,44.31,-6.83999999999999
2022,"CA-14",191633,63737,255370,75.04,24.96,-47.86,240284,87866,328150,73.22,26.78,-41.9
2022,"CA-15",222015,51374,273389,81.21,18.79,-60.2,272883,71568,344451,79.22,20.78,-53.9
2022,"CA-16",244233,64291,308524,79.16,20.84,-56.1,287369,85329,372698,77.11,22.89,-49.68
2022,"CA-17",180481,49279,229760,78.55,21.45,-54.88,220386,76554,296940,74.22,25.78,-43.9
2022,"CA-18",149860,47611,197471,75.89,24.11,-49.56,189742,72113,261855,72.46,27.54,-40.38
2022,"CA-19",228826,92992,321818,71.1,28.9,-39.98,283379,119441,402820,70.35,29.65,-36.16
2022,"CA-20",86525,169700,256225,33.77,66.23,34.68,128070,214158,342228,37.42,62.58,29.7
2022,"CA-21",100349,62603,162952,61.58,38.42,-20.94,132710,86224,218934,60.62,39.38,-16.7
2022,"CA-22",80630,57552,138182,58.35,41.65,-14.48,103391,79455,182846,56.55,43.45,-8.55999999999999
2022,"CA-23",95754,130836,226590,42.26,57.74,17.7,132756,161906,294662,45.05,54.95,14.44
2022,"CA-24",191980,110314,302294,63.51,36.49,-24.8,240790,130686,371476,64.82,35.18,-25.1
2022,"CA-25",115179,79466,194645,59.17,40.83,-16.12,150195,109514,259709,57.83,42.17,-11.12
2022,"CA-26",172942,119320,292262,59.17,40.83,-16.12,222913,147382,370295,60.2,39.8,-15.86
2022,"CA-27",137687,111744,249431,55.2,44.8,-8.18,188387,146015,334402,56.34,43.66,-8.14
2022,"CA-28",187993,87418,275411,68.26,31.74,-34.3,244036,119128,363164,67.2,32.8,-29.86
2022,"CA-29",166462,35701,202163,82.34,17.66,-62.46,203270,63622,266892,76.16,23.84,-47.78
2022,"CA-30",228305,64215,292520,78.05,21.95,-53.88,276071,99076,375147,73.59,26.41,-42.64
2022,"CA-31",155880,67883,223763,69.66,30.34,-37.1,197792,102318,300110,65.91,34.09,-27.28
2022,"CA-32",222769,79208,301977,73.77,26.23,-45.32,271815,111949,383764,70.83,29.17,-37.12
2022,"CA-33",128085,66116,194201,65.95,34.05,-29.68,166434,97473,263907,63.07,36.93,-21.6
2022,"CA-34",166291,20407,186698,89.07,10.93,-75.92,203669,42005,245674,82.9,17.1,-61.26
2022,"CA-35",128546,59317,187863,68.43,31.57,-34.64,170762,94495,265257,64.38,35.62,-24.22
2022,"CA-36",246970,88562,335532,73.61,26.39,-45,296540,112560,409100,72.49,27.51,-40.44
2022,"CA-37",205438,17068,222506,92.33,7.67,-82.44,240555,35028,275583,87.29,12.71,-70.04
2022,"CA-38",172850,77412,250262,69.07,30.93,-35.92,217554,115040,332594,65.41,34.59,-26.28
2022,"CA-39",125724,66722,192446,65.33,34.67,-28.44,163913,94669,258582,63.39,36.61,-22.24
2022,"CA-40",154067,168430,322497,47.77,52.23,6.67999999999999,212702,204283,416985,51.01,48.99,2.52000000000001
2022,"CA-41",122260,138695,260955,46.85,53.15,8.52,181487,185153,366640,49.5,50.5,5.54000000000001
2022,"CA-42",170848,51370,222218,76.88,23.12,-51.54,209481,75869,285350,73.41,26.59,-42.28
2022,"CA-43",185854,25261,211115,88.03,11.97,-73.84,220931,46671,267602,82.56,17.44,-60.58
2022,"CA-44",176630,44202,220832,79.98,20.02,-57.74,211679,71436,283115,74.77,25.23,-45
2022,"CA-45",147146,110815,257961,57.04,42.96,-11.86,186674,164569,351243,53.15,46.85,-1.75999999999999
2022,"CA-46",128737,52489,181226,71.04,28.96,-39.86,161388,84808,246196,65.55,34.45,-26.56
2022,"CA-47",154139,131539,285678,53.96,46.04,-5.7,212914,169608,382522,55.66,44.34,-6.77999999999999
2022,"CA-48",114971,175738,290709,39.55,60.45,23.12,167574,215176,382750,43.78,56.22,16.98
2022,"CA-49",160271,142240,302511,52.98,47.02,-3.74,221303,175104,396407,55.83,44.17,-7.11999999999999
2022,"CA-50",197721,108698,306419,64.53,35.47,-26.84,263306,130241,393547,66.91,33.09,-29.28
2022,"CA-51",174051,105573,279624,62.24,37.76,-22.26,230681,129939,360620,63.97,36.03,-23.4
2022,"CA-52",170826,58094,228920,74.62,25.38,-47.02,205015,92676,297691,68.87,31.13,-33.2
2008,"CO-01",262590,72699,335289,78.32,21.68,-54.42,337400,82282,419682,80.39,19.61,-56.24
2008,"CO-02",243841,137641,381482,63.92,36.08,-25.62,315917,156096,472013,66.93,33.07,-29.32
2008,"CO-03",144906,195632,340538,42.55,57.45,17.12,192086,224953,417039,46.06,53.94,12.42
2008,"CO-04",168878,204016,372894,45.29,54.71,11.64,229140,233360,462500,49.54,50.46,5.46000000000002
2008,"CO-05",125162,213932,339094,36.91,63.09,28.4,186638,242981,429619,43.44,56.56,17.66
2008,"CO-06",214682,251585,466267,46.04,53.96,10.14,303311,284658,587969,51.59,48.41,1.36
2008,"CO-07",178804,126976,305780,58.47,41.53,-14.72,239860,140276,380136,63.1,36.9,-21.66
2010,"CO-01",262590,72699,335289,78.32,21.68,-54.42,337400,82282,419682,80.39,19.61,-56.24
2010,"CO-02",243841,137641,381482,63.92,36.08,-25.62,315917,156096,472013,66.93,33.07,-29.32
2010,"CO-03",144906,195632,340538,42.55,57.45,17.12,192086,224953,417039,46.06,53.94,12.42
2010,"CO-04",168878,204016,372894,45.29,54.71,11.64,229140,233360,462500,49.54,50.46,5.46000000000002
2010,"CO-05",125162,213932,339094,36.91,63.09,28.4,186638,242981,429619,43.44,56.56,17.66
2010,"CO-06",214682,251585,466267,46.04,53.96,10.14,303311,284658,587969,51.59,48.41,1.36
2010,"CO-07",178804,126976,305780,58.47,41.53,-14.72,239860,140276,380136,63.1,36.9,-21.66
2012,"CO-01",277762,93603,371365,74.79,25.21,-47.36,357779,104641,462420,77.37,22.63,-50.2
2012,"CO-02",264643,164496,429139,61.67,38.33,-21.12,337876,178291,516167,65.46,34.54,-26.38
2012,"CO-03",151057,195966,347023,43.53,56.47,15.16,200886,224996,425882,47.17,52.83,10.2
2012,"CO-04",137788,230957,368745,37.37,62.63,27.48,198978,276328,475306,41.86,58.14,20.82
2012,"CO-05",123537,212558,336095,36.76,63.24,28.7,184301,241369,425670,43.3,56.7,17.94
2012,"CO-06",191214,157105,348319,54.9,45.1,-7.58000000000001,260842,175737,436579,59.75,40.25,-14.96
2012,"CO-07",192873,147806,340679,56.61,43.39,-11,263683,163242,426925,61.76,38.24,-18.98
2014,"CO-01",277777,93601,371378,74.8,25.2,-47.38,357814,104641,462455,77.37,22.63,-50.2
2014,"CO-02",264643,164496,429139,61.67,38.33,-21.12,337876,178291,516167,65.46,34.54,-26.38
2014,"CO-03",151057,195966,347023,43.53,56.47,15.16,200886,224996,425882,47.17,52.83,10.2
2014,"CO-04",137788,230957,368745,37.37,62.63,27.48,198978,276328,475306,41.86,58.14,20.82
2014,"CO-05",123537,212558,336095,36.76,63.24,28.7,184301,241369,425670,43.3,56.7,17.94
2014,"CO-06",191199,157107,348306,54.89,45.11,-7.56000000000001,260807,175737,436544,59.74,40.26,-14.94
2014,"CO-07",192873,147806,340679,56.61,43.39,-11,263683,163242,426925,61.76,38.24,-18.98
2016,"CO-01",277777,93597,371374,74.8,25.2,-47.38,357817,104636,462453,77.37,22.63,-50.2
2016,"CO-02",264643,164496,429139,61.67,38.33,-21.12,337876,178291,516167,65.46,34.54,-26.38
2016,"CO-03",151057,195966,347023,43.53,56.47,15.16,200886,224996,425882,47.17,52.83,10.2
2016,"CO-04",137788,230957,368745,37.37,62.63,27.48,198978,276328,475306,41.86,58.14,20.82
2016,"CO-05",123537,212558,336095,36.76,63.24,28.7,184301,241369,425670,43.3,56.7,17.94
2016,"CO-06",191193,157104,348297,54.89,45.11,-7.56000000000001,260798,175734,436532,59.74,40.26,-14.94
2016,"CO-07",192884,147814,340698,56.61,43.39,-11,263696,163252,426948,61.76,38.24,-18.98
2018,"CO-01",277705,93557,371262,74.8,25.2,-47.38,357685,104569,462254,77.38,22.62,-50.22
2018,"CO-02",264814,164640,429454,61.66,38.34,-21.1,338080,178444,516524,65.45,34.55,-26.36
2018,"CO-03",151057,195966,347023,43.53,56.47,15.16,200886,224996,425882,47.17,52.83,10.2
2018,"CO-04",137804,230965,368769,37.37,62.63,27.48,199001,276336,475337,41.87,58.13,20.8
2018,"CO-05",123537,212558,336095,36.76,63.24,28.7,184301,241369,425670,43.3,56.7,17.94
2018,"CO-06",191238,157122,348360,54.9,45.1,-7.58000000000001,260853,175755,436608,59.75,40.25,-14.96
2018,"CO-07",192724,147686,340410,56.62,43.38,-11.02,263546,163136,426682,61.77,38.23,-19
2020,"CO-01",277862,93575,371437,74.81,25.19,-47.4,357933,104606,462539,77.38,22.62,-50.22
2020,"CO-02",264811,164638,429449,61.66,38.34,-21.1,338078,178442,516520,65.45,34.55,-26.36
2020,"CO-03",151057,195966,347023,43.53,56.47,15.16,200886,224996,425882,47.17,52.83,10.2
2020,"CO-04",137810,230971,368781,37.37,62.63,27.48,199010,276343,475353,41.87,58.13,20.8
2020,"CO-05",123537,212558,336095,36.76,63.24,28.7,184301,241369,425670,43.3,56.7,17.94
2020,"CO-06",191101,157099,348200,54.88,45.12,-7.54,260642,175711,436353,59.73,40.27,-14.92
2020,"CO-07",192700,147687,340387,56.61,43.39,-11,263502,163139,426641,61.76,38.24,-18.98
2022,"CO-01",246248,63342,309590,79.54,20.46,-56.86,315477,72271,387748,81.36,18.64,-58.18
2022,"CO-02",242568,121866,364434,66.56,33.44,-30.9,305519,128421,433940,70.41,29.59,-36.28
2022,"CO-03",140732,190923,331655,42.43,57.57,17.36,186117,219697,405814,45.86,54.14,12.82
2022,"CO-04",116481,215712,332193,35.06,64.94,32.1,173749,255391,429140,40.49,59.51,23.56
2022,"CO-05",107360,175787,283147,37.92,62.08,26.38,161060,198719,359779,44.77,55.23,15
2022,"CO-06",174359,130332,304691,57.22,42.78,-12.22,232926,141252,374178,62.25,37.75,-19.96
2022,"CO-07",185545,173878,359423,51.62,48.38,-1.02,256111,190949,447060,57.29,42.71,-10.04
2022,"CO-08",125577,130643,256220,49.01,50.99,4.2,173393,157907,331300,52.34,47.66,-0.139999999999986
2008,"CT-01",193060,117589,310649,62.15,37.85,-22.08,226242,125908,352150,64.25,35.75,-23.96
2008,"CT-02",161997,152939,314936,51.44,48.56,-0.660000000000004,200944,161567,362511,55.43,44.57,-6.31999999999999
2008,"CT-03",165668,118698,284366,58.26,41.74,-14.3,195128,125734,320862,60.81,39.19,-17.08
2008,"CT-04",185910,114895,300805,61.8,38.2,-21.38,225714,121592,347306,64.99,35.01,-25.44
2008,"CT-05",160901,147577,308478,52.16,47.84,-2.1,195810,157529,353339,55.42,44.58,-6.3
2010,"CT-01",193060,117589,310649,62.15,37.85,-22.08,226242,125908,352150,64.25,35.75,-23.96
2010,"CT-02",161997,152939,314936,51.44,48.56,-0.660000000000004,200944,161567,362511,55.43,44.57,-6.31999999999999
2010,"CT-03",165668,118698,284366,58.26,41.74,-14.3,195128,125734,320862,60.81,39.19,-17.08
2010,"CT-04",185910,114895,300805,61.8,38.2,-21.38,225714,121592,347306,64.99,35.01,-25.44
2010,"CT-05",160901,147577,308478,52.16,47.84,-2.1,195810,157529,353339,55.42,44.58,-6.3
2012,"CT-01",195389,119522,314911,62.05,37.95,-21.88,229328,127939,357267,64.19,35.81,-23.84
2012,"CT-02",157552,149113,306665,51.38,48.62,-0.539999999999999,195246,157480,352726,55.35,44.65,-6.16
2012,"CT-03",165978,118305,284283,58.38,41.62,-14.54,195281,125320,320601,60.91,39.09,-17.28
2012,"CT-04",187579,116985,304564,61.59,38.41,-20.96,227993,123850,351843,64.8,35.2,-25.06
2012,"CT-05",161038,147773,308811,52.15,47.85,-2.08,195989,157740,353729,55.41,44.59,-6.27999999999999
2014,"CT-01",195389,119522,314911,62.05,37.95,-21.88,229328,127939,357267,64.19,35.81,-23.84
2014,"CT-02",157552,149113,306665,51.38,48.62,-0.539999999999999,195246,157480,352726,55.35,44.65,-6.16
2014,"CT-03",165978,118305,284283,58.38,41.62,-14.54,195281,125320,320601,60.91,39.09,-17.28
2014,"CT-04",187579,116985,304564,61.59,38.41,-20.96,227993,123850,351843,64.8,35.2,-25.06
2014,"CT-05",161038,147773,308811,52.15,47.85,-2.08,195989,157740,353729,55.41,44.59,-6.27999999999999
2016,"CT-01",195389,119522,314911,62.05,37.95,-21.88,229328,127939,357267,64.19,35.81,-23.84
2016,"CT-02",157558,149120,306678,51.38,48.62,-0.539999999999999,195253,157486,352739,55.35,44.65,-6.16
2016,"CT-03",165978,118305,284283,58.38,41.62,-14.54,195281,125320,320601,60.91,39.09,-17.28
2016,"CT-04",187579,116985,304564,61.59,38.41,-20.96,227993,123850,351843,64.8,35.2,-25.06
2016,"CT-05",161038,147773,308811,52.15,47.85,-2.08,195989,157740,353729,55.41,44.59,-6.27999999999999
2018,"CT-01",195389,119522,314911,62.05,37.95,-21.88,229328,127939,357267,64.19,35.81,-23.84
2018,"CT-02",157558,149120,306678,51.38,48.62,-0.539999999999999,195253,157486,352739,55.35,44.65,-6.16
2018,"CT-03",165978,118305,284283,58.38,41.62,-14.54,195281,125320,320601,60.91,39.09,-17.28
2018,"CT-04",187589,116992,304581,61.59,38.41,-20.96,228006,123857,351863,64.8,35.2,-25.06
2018,"CT-05",161028,147766,308794,52.15,47.85,-2.08,195976,157733,353709,55.41,44.59,-6.27999999999999
2020,"CT-01",195394,119525,314919,62.05,37.95,-21.88,229335,127942,357277,64.19,35.81,-23.84
2020,"CT-02",157558,149120,306678,51.38,48.62,-0.539999999999999,195253,157486,352739,55.35,44.65,-6.16
2020,"CT-03",165974,118312,284286,58.38,41.62,-14.54,195279,125329,320608,60.91,39.09,-17.28
2020,"CT-04",187578,116983,304561,61.59,38.41,-20.96,227989,123846,351835,64.8,35.2,-25.06
2020,"CT-05",161038,147765,308803,52.15,47.85,-2.08,195988,157733,353721,55.41,44.59,-6.27999999999999
2022,"CT-01",194390,118371,312761,62.15,37.85,-22.08,227705,126794,354499,64.23,35.77,-23.92
2022,"CT-02",164333,153817,318150,51.65,48.35,-1.08,203782,162486,366268,55.64,44.36,-6.73999999999999
2022,"CT-03",166192,122792,288984,57.51,42.49,-12.8,196421,130054,326475,60.16,39.84,-15.78
2022,"CT-04",182609,110154,292763,62.37,37.63,-22.52,221201,116539,337740,65.49,34.51,-26.44
2022,"CT-05",160216,146663,306879,52.21,47.79,-2.2,194980,156559,351539,55.46,44.54,-6.38
2008,"DE-01",235603,185127,420730,56,44,-9.78000000000001,296268,200603,496871,59.63,40.37,-14.72
2010,"DE-01",235603,185127,420730,56,44,-9.78000000000001,296268,200603,496871,59.63,40.37,-14.72
2012,"DE-01",235603,185127,420730,56,44,-9.78000000000001,296268,200603,496871,59.63,40.37,-14.72
2014,"DE-01",235603,185127,420730,56,44,-9.78000000000001,296268,200603,496871,59.63,40.37,-14.72
2016,"DE-01",235603,185127,420730,56,44,-9.78000000000001,296268,200603,496871,59.63,40.37,-14.72
2018,"DE-01",235603,185127,420730,56,44,-9.78000000000001,296268,200603,496871,59.63,40.37,-14.72
2020,"DE-01",235603,185127,420730,56,44,-9.78000000000001,296268,200603,496871,59.63,40.37,-14.72
2022,"DE-01",235603,185127,420730,56,44,-9.78000000000001,296268,200603,496871,59.63,40.37,-14.72
2008,"FL-01",103375,246630,350005,29.54,70.46,43.14,137092,279659,416751,32.9,67.1,38.74
2008,"FL-02",156118,214626,370744,42.11,57.89,18,177539,236729,414268,42.86,57.14,18.82
2008,"FL-03",181414,90060,271474,66.83,33.17,-31.44,200454,105888,306342,65.43,34.57,-26.32
2008,"FL-04",141993,237470,379463,37.42,62.58,27.38,183213,270009,453222,40.42,59.58,23.7
2008,"FL-05",183987,339817,523804,35.13,64.87,31.96,237879,417118,654997,36.32,63.68,31.9
2008,"FL-06",166868,246082,412950,40.41,59.59,21.4,208017,280991,489008,42.54,57.46,19.46
2008,"FL-07",183578,257037,440615,41.66,58.34,18.9,235678,311644,547322,43.06,56.94,18.42
2008,"FL-08",217170,177505,394675,55.03,44.97,-7.84,265784,222842,488626,54.39,45.61,-4.24
2008,"FL-09",163588,220735,384323,42.57,57.43,17.08,200671,256824,457495,43.86,56.14,16.82
2008,"FL-10",155909,171015,326924,47.69,52.31,6.84,186795,197954,384749,48.55,51.45,7.44
2008,"FL-11",187853,98173,286026,65.68,34.32,-29.14,211019,124980,335999,62.8,37.2,-21.06
2008,"FL-12",183505,204712,388217,47.27,52.73,7.67999999999999,231818,255699,487517,47.55,52.45,9.44
2008,"FL-13",174394,244893,419287,41.59,58.41,19.04,216989,295086,512075,42.37,57.63,19.8
2008,"FL-14",173762,283185,456947,38.03,61.97,26.16,219099,341017,560116,39.12,60.88,26.3
2008,"FL-15",206424,239759,446183,46.26,53.74,9.7,257338,295763,553101,46.53,53.47,11.48
2008,"FL-16",161846,238208,400054,40.46,59.54,21.3,198849,285902,484751,41.02,58.98,22.5
2008,"FL-17",217220,33861,251081,86.51,13.49,-70.8,226036,58160,284196,79.54,20.46,-54.54
2008,"FL-18",164921,108319,273240,60.36,39.64,-18.5,171671,159478,331149,51.84,48.16,0.860000000000007
2008,"FL-19",231159,139229,370388,62.41,37.59,-22.6,266872,172986,439858,60.67,39.33,-16.8
2008,"FL-20",209153,113328,322481,64.86,35.14,-27.5,229090,150295,379385,60.38,39.62,-16.22
2008,"FL-21",162031,113627,275658,58.78,41.22,-15.34,153139,170844,323983,47.27,52.73,10
2008,"FL-22",187768,185081,372849,50.36,49.64,1.49999999999999,222467,220362,442829,50.24,49.76,4.06000000000001
2008,"FL-23",216728,51906,268634,80.68,19.32,-59.14,238953,69332,308285,77.51,22.49,-50.48
2008,"FL-24",190510,220078,410588,46.4,53.6,9.41999999999999,234391,260197,494588,47.39,52.61,9.76000000000001
2008,"FL-25",180448,138964,319412,56.49,43.51,-10.76,183281,225459,408740,44.84,55.16,14.86
2010,"FL-01",103375,246630,350005,29.54,70.46,43.14,137092,279659,416751,32.9,67.1,38.74
2010,"FL-02",156118,214626,370744,42.11,57.89,18,177539,236729,414268,42.86,57.14,18.82
2010,"FL-03",181414,90060,271474,66.83,33.17,-31.44,200454,105888,306342,65.43,34.57,-26.32
2010,"FL-04",141993,237470,379463,37.42,62.58,27.38,183213,270009,453222,40.42,59.58,23.7
2010,"FL-05",183987,339817,523804,35.13,64.87,31.96,237879,417118,654997,36.32,63.68,31.9
2010,"FL-06",166868,246082,412950,40.41,59.59,21.4,208017,280991,489008,42.54,57.46,19.46
2010,"FL-07",183578,257037,440615,41.66,58.34,18.9,235678,311644,547322,43.06,56.94,18.42
2010,"FL-08",217170,177505,394675,55.03,44.97,-7.84,265784,222842,488626,54.39,45.61,-4.24
2010,"FL-09",163588,220735,384323,42.57,57.43,17.08,200671,256824,457495,43.86,56.14,16.82
2010,"FL-10",155909,171015,326924,47.69,52.31,6.84,186795,197954,384749,48.55,51.45,7.44
2010,"FL-11",187853,98173,286026,65.68,34.32,-29.14,211019,124980,335999,62.8,37.2,-21.06
2010,"FL-12",183505,204712,388217,47.27,52.73,7.67999999999999,231818,255699,487517,47.55,52.45,9.44
2010,"FL-13",174394,244893,419287,41.59,58.41,19.04,216989,295086,512075,42.37,57.63,19.8
2010,"FL-14",173762,283185,456947,38.03,61.97,26.16,219099,341017,560116,39.12,60.88,26.3
2010,"FL-15",206424,239759,446183,46.26,53.74,9.7,257338,295763,553101,46.53,53.47,11.48
2010,"FL-16",161846,238208,400054,40.46,59.54,21.3,198849,285902,484751,41.02,58.98,22.5
2010,"FL-17",217220,33861,251081,86.51,13.49,-70.8,226036,58160,284196,79.54,20.46,-54.54
2010,"FL-18",164921,108319,273240,60.36,39.64,-18.5,171671,159478,331149,51.84,48.16,0.860000000000007
2010,"FL-19",231159,139229,370388,62.41,37.59,-22.6,266872,172986,439858,60.67,39.33,-16.8
2010,"FL-20",209153,113328,322481,64.86,35.14,-27.5,229090,150295,379385,60.38,39.62,-16.22
2010,"FL-21",162031,113627,275658,58.78,41.22,-15.34,153139,170844,323983,47.27,52.73,10
2010,"FL-22",187768,185081,372849,50.36,49.64,1.49999999999999,222467,220362,442829,50.24,49.76,4.06000000000001
2010,"FL-23",216728,51906,268634,80.68,19.32,-59.14,238953,69332,308285,77.51,22.49,-50.48
2010,"FL-24",190510,220078,410588,46.4,53.6,9.41999999999999,234391,260197,494588,47.39,52.61,9.76000000000001
2010,"FL-25",180448,138964,319412,56.49,43.51,-10.76,183281,225459,408740,44.84,55.16,14.86
2012,"FL-01",107060,256570,363630,29.44,70.56,43.34,143653,292008,435661,32.97,67.03,38.6
2012,"FL-02",154353,187588,341941,45.14,54.86,11.94,173452,204711,378163,45.87,54.13,12.8
2012,"FL-03",124742,215482,340224,36.66,63.34,28.9,153171,245912,399083,38.38,61.62,27.78
2012,"FL-04",139533,228116,367649,37.95,62.05,26.32,184126,257692,441818,41.67,58.33,21.2
2012,"FL-05",193049,84983,278032,69.43,30.57,-36.64,214850,99450,314300,68.36,31.64,-32.18
2012,"FL-06",150930,247484,398414,37.88,62.12,26.46,194254,305359,499613,38.88,61.12,26.78
2012,"FL-07",172737,174733,347470,49.71,50.29,2.8,212921,200747,413668,51.47,48.53,1.6
2012,"FL-08",151403,234624,386027,39.22,60.78,23.78,189798,272081,461879,41.09,58.91,22.36
2012,"FL-09",215533,119148,334681,64.4,35.6,-26.58,249090,169527,418617,59.5,40.5,-14.46
2012,"FL-10",174092,194917,369009,47.18,52.82,7.86,232172,243897,476069,48.77,51.23,7
2012,"FL-11",129881,257381,387262,33.54,66.46,35.14,156875,304883,461758,33.97,66.03,36.6
2012,"FL-12",147315,218303,365618,40.29,59.71,21.64,189093,265873,454966,41.56,58.44,21.42
2012,"FL-13",166594,186757,353351,47.15,52.85,7.91999999999999,197873,215090,412963,47.92,52.08,8.70000000000001
2012,"FL-14",199338,106564,305902,65.16,34.84,-28.1,230567,137903,368470,62.57,37.43,-20.6
2012,"FL-15",141263,179124,320387,44.09,55.91,14.04,169385,209623,379008,44.69,55.31,15.16
2012,"FL-16",167973,222716,390689,42.99,57.01,16.24,208370,267653,476023,43.77,56.23,17
2012,"FL-17",122867,209978,332845,36.91,63.09,28.4,160269,259834,420103,38.15,61.85,28.24
2012,"FL-18",168772,205270,374042,45.12,54.88,11.98,206726,246420,453146,45.62,54.38,13.3
2012,"FL-19",142743,226907,369650,38.62,61.38,24.98,180693,272781,453474,39.85,60.15,24.84
2012,"FL-20",223289,52089,275378,81.08,18.92,-59.94,245627,69401,315028,77.97,22.03,-51.4
2012,"FL-21",213850,139385,353235,60.54,39.46,-18.86,248778,171304,420082,59.22,40.78,-13.9
2012,"FL-22",196373,153229,349602,56.17,43.83,-10.12,228580,183025,411605,55.53,44.47,-6.52
2012,"FL-23",197066,112466,309532,63.67,36.33,-25.12,211586,154272,365858,57.83,42.17,-11.12
2012,"FL-24",233837,37270,271107,86.25,13.75,-70.28,246903,67544,314447,78.52,21.48,-52.5
2012,"FL-25",144358,130503,274861,52.52,47.48,-2.82000000000001,142241,196142,338383,42.04,57.96,20.46
2012,"FL-26",163946,125483,289429,56.64,43.36,-11.06,160436,189926,350362,45.79,54.21,12.96
2012,"FL-27",158852,107245,266097,59.7,40.3,-17.18,162752,162233,324985,50.08,49.92,4.38
2014,"FL-01",107060,256570,363630,29.44,70.56,43.34,143653,292008,435661,32.97,67.03,38.6
2014,"FL-02",154353,187588,341941,45.14,54.86,11.94,173452,204711,378163,45.87,54.13,12.8
2014,"FL-03",124742,215482,340224,36.66,63.34,28.9,153171,245912,399083,38.38,61.62,27.78
2014,"FL-04",139533,228116,367649,37.95,62.05,26.32,184126,257692,441818,41.67,58.33,21.2
2014,"FL-05",193049,84983,278032,69.43,30.57,-36.64,214850,99450,314300,68.36,31.64,-32.18
2014,"FL-06",150930,247484,398414,37.88,62.12,26.46,194254,305359,499613,38.88,61.12,26.78
2014,"FL-07",172737,174733,347470,49.71,50.29,2.8,212921,200747,413668,51.47,48.53,1.6
2014,"FL-08",151403,234624,386027,39.22,60.78,23.78,189798,272081,461879,41.09,58.91,22.36
2014,"FL-09",215533,119148,334681,64.4,35.6,-26.58,249090,169527,418617,59.5,40.5,-14.46
2014,"FL-10",174092,194917,369009,47.18,52.82,7.86,232172,243897,476069,48.77,51.23,7
2014,"FL-11",129881,257381,387262,33.54,66.46,35.14,156875,304883,461758,33.97,66.03,36.6
2014,"FL-12",147315,218303,365618,40.29,59.71,21.64,189093,265873,454966,41.56,58.44,21.42
2014,"FL-13",166594,186757,353351,47.15,52.85,7.91999999999999,197873,215090,412963,47.92,52.08,8.70000000000001
2014,"FL-14",199338,106564,305902,65.16,34.84,-28.1,230567,137903,368470,62.57,37.43,-20.6
2014,"FL-15",141263,179124,320387,44.09,55.91,14.04,169385,209623,379008,44.69,55.31,15.16
2014,"FL-16",167973,222716,390689,42.99,57.01,16.24,208370,267653,476023,43.77,56.23,17
2014,"FL-17",122867,209978,332845,36.91,63.09,28.4,160269,259834,420103,38.15,61.85,28.24
2014,"FL-18",168772,205270,374042,45.12,54.88,11.98,206726,246420,453146,45.62,54.38,13.3
2014,"FL-19",142732,226889,369621,38.62,61.38,24.98,180690,272779,453469,39.85,60.15,24.84
2014,"FL-20",223280,52077,275357,81.09,18.91,-59.96,245616,69389,315005,77.97,22.03,-51.4
2014,"FL-21",213876,139410,353286,60.54,39.46,-18.86,248808,171334,420142,59.22,40.78,-13.9
2014,"FL-22",196356,153216,349572,56.17,43.83,-10.12,228561,183007,411568,55.53,44.47,-6.52
2014,"FL-23",197084,112476,309560,63.67,36.33,-25.12,211607,154286,365893,57.83,42.17,-11.12
2014,"FL-24",233837,37270,271107,86.25,13.75,-70.28,246903,67544,314447,78.52,21.48,-52.5
2014,"FL-25",144351,130511,274862,52.52,47.48,-2.82000000000001,142223,196130,338353,42.03,57.97,20.48
2014,"FL-26",163946,125483,289429,56.64,43.36,-11.06,160436,189926,350362,45.79,54.21,12.96
2014,"FL-27",158852,107245,266097,59.7,40.3,-17.18,162752,162233,324985,50.08,49.92,4.38
2016,"FL-01",107060,256570,363630,29.44,70.56,43.34,143653,292008,435661,32.97,67.03,38.6
2016,"FL-02",108599,234688,343287,31.64,68.36,38.94,125807,263163,388970,32.34,67.66,39.86
2016,"FL-03",141334,197419,338753,41.72,58.28,18.78,170390,223010,393400,43.31,56.69,17.92
2016,"FL-04",147070,262832,409902,35.88,64.12,30.46,202762,308030,510792,39.7,60.3,25.14
2016,"FL-05",187153,109871,297024,63.01,36.99,-23.8,209482,120590,330072,63.47,36.53,-22.4
2016,"FL-06",151660,216781,368441,41.16,58.84,19.9,184930,264474,449404,41.15,58.85,22.24
2016,"FL-07",186069,159755,345824,53.8,46.2,-5.38,226456,183360,409816,55.26,44.74,-5.97999999999999
2016,"FL-08",151420,234637,386057,39.22,60.78,23.78,189819,272097,461916,41.09,58.91,22.36
2016,"FL-09",195302,149348,344650,56.67,43.33,-11.12,232329,201935,434264,53.5,46.5,-2.45999999999999
2016,"FL-10",194948,110059,305007,63.92,36.08,-25.62,236894,141418,378312,62.62,37.38,-20.7
2016,"FL-11",133738,266579,400317,33.41,66.59,35.4,164764,318664,483428,34.08,65.92,36.38
2016,"FL-12",147966,218979,366945,40.32,59.68,21.58,188706,266355,455061,41.47,58.53,21.6
2016,"FL-13",178897,167345,346242,51.67,48.33,-1.12,211416,194611,406027,52.07,47.93,0.399999999999999
2016,"FL-14",188519,128425,316944,59.48,40.52,-16.74,216746,158003,374749,57.84,42.16,-11.14
2016,"FL-15",144580,177789,322369,44.85,55.15,12.52,180410,214006,394416,45.74,54.26,13.06
2016,"FL-16",170414,213168,383582,44.43,55.57,13.36,223460,262929,486389,45.94,54.06,12.66
2016,"FL-17",123937,220236,344173,36.01,63.99,30.2,151892,267578,419470,36.21,63.79,32.12
2016,"FL-18",168625,203810,372435,45.28,54.72,11.66,206482,244785,451267,45.76,54.24,13.02
2016,"FL-19",142732,226889,369621,38.62,61.38,24.98,180690,272779,453469,39.85,60.15,24.84
2016,"FL-20",231736,52602,284338,81.5,18.5,-60.78,255260,73386,328646,77.67,22.33,-50.8
2016,"FL-21",206165,137431,343596,60,40,-17.78,239296,169488,408784,58.54,41.46,-12.54
2016,"FL-22",201795,145784,347579,58.06,41.94,-13.9,235283,174144,409427,57.47,42.53,-10.4
2016,"FL-23",208881,120795,329676,63.36,36.64,-24.5,227852,160827,388679,58.62,41.38,-12.7
2016,"FL-24",219513,40742,260255,84.35,15.65,-66.48,226717,71690,298407,75.98,24.02,-47.42
2016,"FL-25",128640,131963,260603,49.36,50.64,3.49999999999999,122096,197616,319712,38.19,61.81,28.16
2016,"FL-26",161241,113918,275159,58.6,41.4,-14.98,161925,180548,342473,47.28,52.72,9.98
2016,"FL-27",173746,115909,289655,59.98,40.02,-17.74,178712,167782,346494,51.58,48.42,1.38
2018,"FL-01",107060,256570,363630,29.44,70.56,43.34,143653,292008,435661,32.97,67.03,38.6
2018,"FL-02",108589,234671,343260,31.63,68.37,38.96,125796,263146,388942,32.34,67.66,39.86
2018,"FL-03",141334,197419,338753,41.72,58.28,18.78,170390,223010,393400,43.31,56.69,17.92
2018,"FL-04",147070,262832,409902,35.88,64.12,30.46,202762,308030,510792,39.7,60.3,25.14
2018,"FL-05",187163,109888,297051,63.01,36.99,-23.8,209493,120607,330100,63.46,36.54,-22.38
2018,"FL-06",151654,216777,368431,41.16,58.84,19.9,184935,264482,449417,41.15,58.85,22.24
2018,"FL-07",186235,159850,346085,53.81,46.19,-5.40000000000001,226687,183480,410167,55.27,44.73,-5.99999999999999
2018,"FL-08",151420,234637,386057,39.22,60.78,23.78,189819,272097,461916,41.09,58.91,22.36
2018,"FL-09",195304,149350,344654,56.67,43.33,-11.12,232328,201936,434264,53.5,46.5,-2.45999999999999
2018,"FL-10",194782,109964,304746,63.92,36.08,-25.62,236664,141298,377962,62.62,37.38,-20.7
2018,"FL-11",133757,266598,400355,33.41,66.59,35.4,164783,318685,483468,34.08,65.92,36.38
2018,"FL-12",147960,218976,366936,40.32,59.68,21.58,188698,266352,455050,41.47,58.53,21.6
2018,"FL-13",178903,167348,346251,51.67,48.33,-1.12,211424,194614,406038,52.07,47.93,0.399999999999999
2018,"FL-14",188519,128425,316944,59.48,40.52,-16.74,216746,158003,374749,57.84,42.16,-11.14
2018,"FL-15",144560,177759,322319,44.85,55.15,12.52,180380,213961,394341,45.74,54.26,13.06
2018,"FL-16",170414,213168,383582,44.43,55.57,13.36,223460,262929,486389,45.94,54.06,12.66
2018,"FL-17",123942,220249,344191,36.01,63.99,30.2,151899,267593,419492,36.21,63.79,32.12
2018,"FL-18",168620,203793,372413,45.28,54.72,11.66,206472,244764,451236,45.76,54.24,13.02
2018,"FL-19",142732,226889,369621,38.62,61.38,24.98,180690,272779,453469,39.85,60.15,24.84
2018,"FL-20",231725,52621,284346,81.49,18.51,-60.76,255244,73434,328678,77.66,22.34,-50.78
2018,"FL-21",206214,137456,343670,60,40,-17.78,239342,169497,408839,58.54,41.46,-12.54
2018,"FL-22",201784,145808,347592,58.05,41.95,-13.88,235270,174186,409456,57.46,42.54,-10.38
2018,"FL-23",208854,120757,329611,63.36,36.64,-24.5,227840,160769,388609,58.63,41.37,-12.72
2018,"FL-24",219524,40730,260254,84.35,15.65,-66.48,226728,71674,298402,75.98,24.02,-47.42
2018,"FL-25",128649,131970,260619,49.36,50.64,3.49999999999999,122103,197627,319730,38.19,61.81,28.16
2018,"FL-26",161241,113918,275159,58.6,41.4,-14.98,161925,180548,342473,47.28,52.72,9.98
2018,"FL-27",173735,115901,289636,59.98,40.02,-17.74,178703,167769,346472,51.58,48.42,1.38
2020,"FL-01",107065,256589,363654,29.44,70.56,43.34,143660,292030,435690,32.97,67.03,38.6
2020,"FL-02",108584,234652,343236,31.64,68.36,38.94,125789,263124,388913,32.34,67.66,39.86
2020,"FL-03",141325,197408,338733,41.72,58.28,18.78,170390,223010,393400,43.31,56.69,17.92
2020,"FL-04",147070,262832,409902,35.88,64.12,30.46,202762,308030,510792,39.7,60.3,25.14
2020,"FL-05",187172,109899,297071,63.01,36.99,-23.8,209493,120607,330100,63.46,36.54,-22.38
2020,"FL-06",151651,216769,368420,41.16,58.84,19.9,184931,264471,449402,41.15,58.85,22.24
2020,"FL-07",186235,159850,346085,53.81,46.19,-5.40000000000001,226687,183480,410167,55.27,44.73,-5.99999999999999
2020,"FL-08",151420,234637,386057,39.22,60.78,23.78,189819,272097,461916,41.09,58.91,22.36
2020,"FL-09",195304,149350,344654,56.67,43.33,-11.12,232328,201936,434264,53.5,46.5,-2.45999999999999
2020,"FL-10",194782,109964,304746,63.92,36.08,-25.62,236664,141298,377962,62.62,37.38,-20.7
2020,"FL-11",133756,266596,400352,33.41,66.59,35.4,164782,318683,483465,34.08,65.92,36.38
2020,"FL-12",147969,218987,366956,40.32,59.68,21.58,188707,266364,455071,41.47,58.53,21.6
2020,"FL-13",178894,167337,346231,51.67,48.33,-1.12,211415,194602,406017,52.07,47.93,0.399999999999999
2020,"FL-14",188519,128425,316944,59.48,40.52,-16.74,216746,158003,374749,57.84,42.16,-11.14
2020,"FL-15",144560,177759,322319,44.85,55.15,12.52,180380,213961,394341,45.74,54.26,13.06
2020,"FL-16",170414,213168,383582,44.43,55.57,13.36,223474,262948,486422,45.94,54.06,12.66
2020,"FL-17",123946,220253,344199,36.01,63.99,30.2,151890,267580,419470,36.21,63.79,32.12
2020,"FL-18",168620,203793,372413,45.28,54.72,11.66,206472,244764,451236,45.76,54.24,13.02
2020,"FL-19",142716,226861,369577,38.62,61.38,24.98,180669,272740,453409,39.85,60.15,24.84
2020,"FL-20",231816,52639,284455,81.49,18.51,-60.76,255345,73459,328804,77.66,22.34,-50.78
2020,"FL-21",206214,137456,343670,60,40,-17.78,239343,169498,408841,58.54,41.46,-12.54
2020,"FL-22",201763,145800,347563,58.05,41.95,-13.88,235246,174175,409421,57.46,42.54,-10.38
2020,"FL-23",208807,120749,329556,63.36,36.64,-24.5,227786,160756,388542,58.63,41.37,-12.72
2020,"FL-24",219501,40728,260229,84.35,15.65,-66.48,226704,71672,298376,75.98,24.02,-47.42
2020,"FL-25",128636,131951,260587,49.36,50.64,3.49999999999999,122081,197593,319674,38.19,61.81,28.16
2020,"FL-26",163677,116987,280664,58.32,41.68,-14.42,164767,184053,348820,47.24,52.76,10.06
2020,"FL-27",173611,115822,289433,59.98,40.02,-17.74,178566,167645,346211,51.58,48.42,1.38
2022,"FL-01",104117,243864,347981,29.92,70.08,42.38,139252,275972,415224,33.54,66.46,37.46
2022,"FL-02",159823,204236,364059,43.9,56.1,14.42,180539,225236,405775,44.49,55.51,15.56
2022,"FL-03",141544,192965,334509,42.31,57.69,17.6,166881,222329,389210,42.88,57.12,18.78
2022,"FL-04",150598,186594,337192,44.66,55.34,12.9,185800,212037,397837,46.7,53.3,11.14
2022,"FL-05",129171,207648,336819,38.35,61.65,25.52,174274,241502,415776,41.92,58.08,20.7
2022,"FL-06",134243,221109,355352,37.78,62.22,26.66,162780,265535,428315,38,62,28.54
2022,"FL-07",162391,190503,352894,46.02,53.98,10.18,200961,224065,425026,47.28,52.72,9.98
2022,"FL-08",149520,231945,381465,39.2,60.8,23.82,187361,268585,455946,41.09,58.91,22.36
2022,"FL-09",170796,97240,268036,63.72,36.28,-25.22,197980,138858,336838,58.78,41.22,-13.02
2022,"FL-10",190306,93066,283372,67.16,32.84,-32.1,217287,110689,327976,66.25,33.75,-27.96
2022,"FL-11",138386,189446,327832,42.21,57.79,17.8,190010,237046,427056,44.49,55.51,15.56
2022,"FL-12",121887,224212,346099,35.22,64.78,31.78,150950,274175,425125,35.51,64.49,33.52
2022,"FL-13",176338,208057,384395,45.87,54.13,10.48,208250,238863,447113,46.58,53.42,11.38
2022,"FL-14",198833,125297,324130,61.34,38.66,-20.46,231516,156336,387852,59.69,40.31,-14.84
2022,"FL-15",143057,154765,297822,48.03,51.97,6.16,174971,186218,361189,48.44,51.56,7.66
2022,"FL-16",136486,177859,314345,43.42,56.58,15.38,184406,220800,405206,45.51,54.49,13.52
2022,"FL-17",152041,215019,367060,41.42,58.58,19.38,187285,259116,446401,41.95,58.05,20.64
2022,"FL-18",111724,174322,286046,39.06,60.94,24.1,133450,212145,345595,38.61,61.39,27.32
2022,"FL-19",134021,218089,352110,38.06,61.94,26.1,169881,260897,430778,39.44,60.56,25.66
2022,"FL-20",228855,60216,289071,79.17,20.83,-56.12,252546,78549,331095,76.28,23.72,-48.02
2022,"FL-21",162388,200766,363154,44.72,55.28,12.78,199378,240992,440370,45.28,54.72,13.98
2022,"FL-22",198164,129965,328129,60.39,39.61,-18.56,230232,160722,390954,58.89,41.11,-13.24
2022,"FL-23",198604,148013,346617,57.3,42.7,-12.38,231516,177354,408870,56.62,43.38,-8.7
2022,"FL-24",235432,50434,285866,82.36,17.64,-62.5,245051,83606,328657,74.56,25.44,-44.58
2022,"FL-25",210248,114488,324736,64.74,35.26,-27.26,230765,153055,383820,60.12,39.88,-15.7
2022,"FL-26",131767,120617,252384,52.21,47.79,-2.2,126563,184014,310577,40.75,59.25,23.04
2022,"FL-27",175310,122156,297466,58.93,41.07,-15.64,178271,179316,357587,49.85,50.15,4.84
2022,"FL-28",157965,114358,272323,58.01,41.99,-13.8,158752,180598,339350,46.78,53.22,10.98
2008,"GA-01",85586,171287,256873,33.32,66.68,35.58,111909,205074,316983,35.3,64.7,33.94
2008,"GA-02",114194,110739,224933,50.77,49.23,0.68,129166,125135,254301,50.79,49.21,2.96000000000001
2008,"GA-03",135068,236325,371393,36.37,63.63,29.48,188910,270602,459512,41.11,58.89,22.32
2008,"GA-04",210808,44862,255670,82.45,17.55,-62.68,258295,52053,310348,83.23,16.77,-61.92
2008,"GA-05",238627,49295,287922,82.88,17.12,-63.54,293530,58748,352278,83.32,16.68,-62.1
2008,"GA-06",151069,219670,370739,40.75,59.25,20.72,224338,252131,476469,47.08,52.92,10.38
2008,"GA-07",175449,206985,382434,45.88,54.12,10.46,260647,238586,499233,52.21,47.79,0.120000000000005
2008,"GA-08",113937,164279,278216,40.95,59.05,20.32,142766,191572,334338,42.7,57.3,19.14
2008,"GA-09",69764,267413,337177,20.69,79.31,60.84,107913,331063,438976,24.58,75.42,55.38
2008,"GA-10",109347,205788,315135,34.7,65.3,32.82,145472,249874,395346,36.8,63.2,30.94
2008,"GA-11",104656,219958,324614,32.24,67.76,37.74,151091,262709,413800,36.51,63.49,31.52
2008,"GA-12",132499,122380,254879,51.99,48.01,-1.76,159541,147016,306557,52.04,47.96,0.460000000000008
2008,"GA-13",236953,70124,307077,77.16,22.84,-52.1,300927,77273,378200,79.57,20.43,-54.6
2010,"GA-01",85586,171287,256873,33.32,66.68,35.58,111909,205074,316983,35.3,64.7,33.94
2010,"GA-02",114194,110739,224933,50.77,49.23,0.68,129166,125135,254301,50.79,49.21,2.96000000000001
2010,"GA-03",135068,236325,371393,36.37,63.63,29.48,188910,270602,459512,41.11,58.89,22.32
2010,"GA-04",210808,44862,255670,82.45,17.55,-62.68,258295,52053,310348,83.23,16.77,-61.92
2010,"GA-05",238627,49295,287922,82.88,17.12,-63.54,293530,58748,352278,83.32,16.68,-62.1
2010,"GA-06",151069,219670,370739,40.75,59.25,20.72,224338,252131,476469,47.08,52.92,10.38
2010,"GA-07",175449,206985,382434,45.88,54.12,10.46,260647,238586,499233,52.21,47.79,0.120000000000005
2010,"GA-08",113937,164279,278216,40.95,59.05,20.32,142766,191572,334338,42.7,57.3,19.14
2010,"GA-09",69764,267413,337177,20.69,79.31,60.84,107913,331063,438976,24.58,75.42,55.38
2010,"GA-10",109347,205788,315135,34.7,65.3,32.82,145472,249874,395346,36.8,63.2,30.94
2010,"GA-11",104656,219958,324614,32.24,67.76,37.74,151091,262709,413800,36.51,63.49,31.52
2010,"GA-12",132499,122380,254879,51.99,48.01,-1.76,159541,147016,306557,52.04,47.96,0.460000000000008
2010,"GA-13",236953,70124,307077,77.16,22.84,-52.1,300927,77273,378200,79.57,20.43,-54.6
2012,"GA-01",110630,152890,263520,41.98,58.02,18.26,143359,184836,328195,43.68,56.32,17.18
2012,"GA-02",136579,107327,243906,56,44,-9.78000000000001,155945,121877,277822,56.13,43.87,-7.72
2012,"GA-03",101797,200759,302556,33.65,66.35,34.92,139952,235661,375613,37.26,62.74,30.02
2012,"GA-04",224424,65991,290415,77.28,22.72,-52.34,281205,71786,352991,79.66,20.34,-54.78
2012,"GA-05",258781,36350,295131,87.68,12.32,-73.14,313608,45878,359486,87.24,12.76,-69.94
2012,"GA-06",155477,160244,315721,49.25,50.75,3.71999999999999,221202,175456,396658,55.77,44.23,-6.99999999999999
2012,"GA-07",131548,149653,281201,46.78,53.22,8.66,197888,172263,370151,53.46,46.54,-2.37999999999999
2012,"GA-08",90778,167473,258251,35.15,64.85,31.92,116343,194930,311273,37.38,62.62,29.78
2012,"GA-09",57968,232260,290228,19.97,80.03,62.28,86645,294770,381415,22.72,77.28,59.1
2012,"GA-10",113117,193082,306199,36.94,63.06,28.34,152078,231431,383509,39.65,60.35,25.24
2012,"GA-11",115846,198419,314265,36.86,63.14,28.5,170982,234595,405577,42.16,57.84,20.22
2012,"GA-12",109030,152003,261033,41.77,58.23,18.68,136636,176700,313336,43.61,56.39,17.32
2012,"GA-13",215439,80639,296078,72.76,27.24,-43.3,277580,86259,363839,76.29,23.71,-48.04
2012,"GA-14",56549,192014,248563,22.75,77.25,56.72,81085,235396,316481,25.62,74.38,53.3
2014,"GA-01",110630,152890,263520,41.98,58.02,18.26,143359,184836,328195,43.68,56.32,17.18
2014,"GA-02",136579,107327,243906,56,44,-9.78000000000001,155945,121877,277822,56.13,43.87,-7.72
2014,"GA-03",101797,200759,302556,33.65,66.35,34.92,139952,235661,375613,37.26,62.74,30.02
2014,"GA-04",224424,65991,290415,77.28,22.72,-52.34,281205,71786,352991,79.66,20.34,-54.78
2014,"GA-05",258781,36350,295131,87.68,12.32,-73.14,313608,45878,359486,87.24,12.76,-69.94
2014,"GA-06",155477,160244,315721,49.25,50.75,3.71999999999999,221202,175456,396658,55.77,44.23,-6.99999999999999
2014,"GA-07",131548,149653,281201,46.78,53.22,8.66,197888,172263,370151,53.46,46.54,-2.37999999999999
2014,"GA-08",90778,167473,258251,35.15,64.85,31.92,116343,194930,311273,37.38,62.62,29.78
2014,"GA-09",57968,232260,290228,19.97,80.03,62.28,86645,294770,381415,22.72,77.28,59.1
2014,"GA-10",113117,193082,306199,36.94,63.06,28.34,152078,231431,383509,39.65,60.35,25.24
2014,"GA-11",115846,198419,314265,36.86,63.14,28.5,170982,234595,405577,42.16,57.84,20.22
2014,"GA-12",109030,152003,261033,41.77,58.23,18.68,136636,176700,313336,43.61,56.39,17.32
2014,"GA-13",215439,80639,296078,72.76,27.24,-43.3,277580,86259,363839,76.29,23.71,-48.04
2014,"GA-14",56549,192014,248563,22.75,77.25,56.72,81085,235396,316481,25.62,74.38,53.3
2016,"GA-01",110630,152890,263520,41.98,58.02,18.26,143359,184836,328195,43.68,56.32,17.18
2016,"GA-02",136579,107327,243906,56,44,-9.78000000000001,155945,121877,277822,56.13,43.87,-7.72
2016,"GA-03",101797,200759,302556,33.65,66.35,34.92,139952,235661,375613,37.26,62.74,30.02
2016,"GA-04",224437,65995,290432,77.28,22.72,-52.34,281220,71791,353011,79.66,20.34,-54.78
2016,"GA-05",258781,36350,295131,87.68,12.32,-73.14,313608,45878,359486,87.24,12.76,-69.94
2016,"GA-06",155511,160292,315803,49.24,50.76,3.74,221274,175532,396806,55.76,44.24,-6.97999999999999
2016,"GA-07",131501,149601,281102,46.78,53.22,8.66,197801,172182,369983,53.46,46.54,-2.37999999999999
2016,"GA-08",90778,167473,258251,35.15,64.85,31.92,116343,194930,311273,37.38,62.62,29.78
2016,"GA-09",57968,232260,290228,19.97,80.03,62.28,86645,294770,381415,22.72,77.28,59.1
2016,"GA-10",113117,193082,306199,36.94,63.06,28.34,152078,231431,383509,39.65,60.35,25.24
2016,"GA-11",115846,198419,314265,36.86,63.14,28.5,170982,234595,405577,42.16,57.84,20.22
2016,"GA-12",109030,152003,261033,41.77,58.23,18.68,136636,176700,313336,43.61,56.39,17.32
2016,"GA-13",215439,80639,296078,72.76,27.24,-43.3,277580,86259,363839,76.29,23.71,-48.04
2016,"GA-14",56549,192014,248563,22.75,77.25,56.72,81085,235396,316481,25.62,74.38,53.3
2018,"GA-01",110605,152849,263454,41.98,58.02,18.26,143327,184794,328121,43.68,56.32,17.18
2018,"GA-02",136579,107327,243906,56,44,-9.78000000000001,155945,121877,277822,56.13,43.87,-7.72
2018,"GA-03",101797,200759,302556,33.65,66.35,34.92,139952,235661,375613,37.26,62.74,30.02
2018,"GA-04",224430,65986,290416,77.28,22.72,-52.34,281225,71793,353018,79.66,20.34,-54.78
2018,"GA-05",258774,36350,295124,87.68,12.32,-73.14,313600,45878,359478,87.24,12.76,-69.94
2018,"GA-06",155511,160292,315803,49.24,50.76,3.74,221274,175532,396806,55.76,44.24,-6.97999999999999
2018,"GA-07",131508,149610,281118,46.78,53.22,8.66,197796,172180,369976,53.46,46.54,-2.37999999999999
2018,"GA-08",90778,167473,258251,35.15,64.85,31.92,116343,194930,311273,37.38,62.62,29.78
2018,"GA-09",57968,232260,290228,19.97,80.03,62.28,86645,294770,381415,22.72,77.28,59.1
2018,"GA-10",113117,193082,306199,36.94,63.06,28.34,152078,231431,383509,39.65,60.35,25.24
2018,"GA-11",115846,198419,314265,36.86,63.14,28.5,170982,234595,405577,42.16,57.84,20.22
2018,"GA-12",109030,152003,261033,41.77,58.23,18.68,136636,176700,313336,43.61,56.39,17.32
2018,"GA-13",215446,80639,296085,72.76,27.24,-43.3,277588,86259,363847,76.29,23.71,-48.04
2018,"GA-14",56549,192014,248563,22.75,77.25,56.72,81085,235396,316481,25.62,74.38,53.3
2020,"GA-01",110605,152849,263454,41.98,58.02,18.26,143327,184794,328121,43.68,56.32,17.18
2020,"GA-02",136579,107327,243906,56,44,-9.78000000000001,155945,121877,277822,56.13,43.87,-7.72
2020,"GA-03",101797,200759,302556,33.65,66.35,34.92,139952,235661,375613,37.26,62.74,30.02
2020,"GA-04",224451,65993,290444,77.28,22.72,-52.34,281251,71803,353054,79.66,20.34,-54.78
2020,"GA-05",258774,36350,295124,87.68,12.32,-73.14,313600,45878,359478,87.24,12.76,-69.94
2020,"GA-06",155478,160273,315751,49.24,50.76,3.74,221229,175506,396735,55.76,44.24,-6.97999999999999
2020,"GA-07",131520,149622,281142,46.78,53.22,8.66,197815,172196,370011,53.46,46.54,-2.37999999999999
2020,"GA-08",90778,167473,258251,35.15,64.85,31.92,116343,194930,311273,37.38,62.62,29.78
2020,"GA-09",57968,232260,290228,19.97,80.03,62.28,86645,294770,381415,22.72,77.28,59.1
2020,"GA-10",113117,193082,306199,36.94,63.06,28.34,152078,231431,383509,39.65,60.35,25.24
2020,"GA-11",115845,198390,314235,36.87,63.13,28.48,170964,234560,405524,42.16,57.84,20.22
2020,"GA-12",109030,152003,261033,41.77,58.23,18.68,136636,176700,313336,43.61,56.39,17.32
2020,"GA-13",215441,80640,296081,72.76,27.24,-43.3,277597,86256,363853,76.29,23.71,-48.04
2020,"GA-14",56555,192042,248597,22.75,77.25,56.72,81094,235434,316528,25.62,74.38,53.3
2022,"GA-01",110598,155967,266565,41.49,58.51,19.24,144335,189654,333989,43.22,56.78,18.1
2022,"GA-02",150236,124587,274823,54.67,45.33,-7.12,173449,140456,313905,55.26,44.74,-5.97999999999999
2022,"GA-03",97818,210783,308601,31.7,68.3,38.82,132437,248460,380897,34.77,65.23,35
2022,"GA-04",222492,66102,288594,77.1,22.9,-51.98,277963,72371,350334,79.34,20.66,-54.14
2022,"GA-05",249180,49319,298499,83.48,16.52,-64.74,306536,59800,366336,83.68,16.32,-62.82
2022,"GA-06",114063,202488,316551,36.03,63.97,30.16,175056,236982,412038,42.49,57.51,19.56
2022,"GA-07",142932,106621,249553,57.28,42.72,-12.34,203197,118947,322144,63.08,36.92,-21.62
2022,"GA-08",93991,179923,273914,34.31,65.69,33.6,117996,209245,327241,36.06,63.94,32.42
2022,"GA-09",74447,206616,281063,26.49,73.51,49.24,112702,253244,365946,30.8,69.2,42.94
2022,"GA-10",102728,190094,292822,35.08,64.92,32.06,142893,231765,374658,38.14,61.86,28.26
2022,"GA-11",107889,183911,291800,36.97,63.03,28.28,158037,216279,374316,42.22,57.78,20.1
2022,"GA-12",121425,159359,280784,43.24,56.76,15.74,151073,185596,336669,44.87,55.13,14.8
2022,"GA-13",216578,61394,277972,77.91,22.09,-53.6,273936,66565,340501,80.45,19.55,-56.36
2022,"GA-14",73559,191899,265458,27.71,72.29,46.8,104866,232431,337297,31.09,68.91,42.36
2008,"HI-01",128579,61363,189942,67.69,32.31,-33.16,173776,92326,266102,65.3,34.7,-26.06
2008,"HI-02",138312,67484,205796,67.21,32.79,-32.2,192354,104538,296892,64.79,35.21,-25.04
2010,"HI-01",128579,61363,189942,67.69,32.31,-33.16,173776,92326,266102,65.3,34.7,-26.06
2010,"HI-02",138312,67484,205796,67.21,32.79,-32.2,192354,104538,296892,64.79,35.21,-25.04
2012,"HI-01",132004,63913,195917,67.38,32.62,-32.54,179273,96872,276145,64.92,35.08,-25.3
2012,"HI-02",134887,64934,199821,67.5,32.5,-32.78,186857,99992,286849,65.14,34.86,-25.74
2014,"HI-01",132004,63913,195917,67.38,32.62,-32.54,179273,96872,276145,64.92,35.08,-25.3
2014,"HI-02",134887,64934,199821,67.5,32.5,-32.78,186857,99992,286849,65.14,34.86,-25.74
2016,"HI-01",132004,63913,195917,67.38,32.62,-32.54,179273,96872,276145,64.92,35.08,-25.3
2016,"HI-02",134887,64934,199821,67.5,32.5,-32.78,186857,99992,286849,65.14,34.86,-25.74
2018,"HI-01",132004,63913,195917,67.38,32.62,-32.54,179273,96872,276145,64.92,35.08,-25.3
2018,"HI-02",134887,64934,199821,67.5,32.5,-32.78,186857,99992,286849,65.14,34.86,-25.74
2020,"HI-01",131987,63902,195889,67.38,32.62,-32.54,179249,96861,276110,64.92,35.08,-25.3
2020,"HI-02",134904,64945,199849,67.5,32.5,-32.78,186881,100003,286884,65.14,34.86,-25.74
2022,"HI-01",131543,63520,195063,67.44,32.56,-32.66,178598,96307,274905,64.97,35.03,-25.4
2022,"HI-02",135348,65327,200675,67.45,32.55,-32.68,187532,100557,288089,65.1,34.9,-25.66
2008,"ID-01",102415,242260,344675,29.71,70.29,42.8,157741,330558,488299,32.3,67.7,39.94
2008,"ID-02",87349,166794,254143,34.37,65.63,33.48,129278,223560,352838,36.64,63.36,31.26
2010,"ID-01",102415,242260,344675,29.71,70.29,42.8,157741,330558,488299,32.3,67.7,39.94
2010,"ID-02",87349,166794,254143,34.37,65.63,33.48,129278,223560,352838,36.64,63.36,31.26
2012,"ID-01",91279,229027,320306,28.5,71.5,45.22,140443,313550,453993,30.94,69.06,42.66
2012,"ID-02",98485,180027,278512,35.36,64.64,31.5,146576,240568,387144,37.86,62.14,28.82
2014,"ID-01",91279,229027,320306,28.5,71.5,45.22,140443,313550,453993,30.94,69.06,42.66
2014,"ID-02",98485,180027,278512,35.36,64.64,31.5,146576,240568,387144,37.86,62.14,28.82
2016,"ID-01",91289,229037,320326,28.5,71.5,45.22,140457,313561,454018,30.94,69.06,42.66
2016,"ID-02",98476,180018,278494,35.36,64.64,31.5,146564,240558,387122,37.86,62.14,28.82
2018,"ID-01",91289,229037,320326,28.5,71.5,45.22,140457,313561,454018,30.94,69.06,42.66
2018,"ID-02",98476,180018,278494,35.36,64.64,31.5,146564,240558,387122,37.86,62.14,28.82
2020,"ID-01",91289,229037,320326,28.5,71.5,45.22,140457,313561,454018,30.94,69.06,42.66
2020,"ID-02",98476,180018,278494,35.36,64.64,31.5,146564,240558,387122,37.86,62.14,28.82
2022,"ID-01",85947,220467,306414,28.05,71.95,46.12,131644,302186,433830,30.34,69.66,43.86
2022,"ID-02",103818,188588,292406,35.5,64.5,31.22,155377,251933,407310,38.15,61.85,28.24
2008,"IL-01",208330,37828,246158,84.63,15.37,-67.04,201147,44084,245231,82.02,17.98,-59.5
2008,"IL-02",230718,23633,254351,90.71,9.29,-79.2,226220,26570,252790,89.49,10.51,-74.44
2008,"IL-03",160650,83668,244318,65.75,34.25,-29.28,176307,99838,276145,63.85,36.15,-23.16
2008,"IL-04",155596,16653,172249,90.33,9.67,-78.44,167526,26065,193591,86.54,13.46,-68.54
2008,"IL-05",196984,56782,253766,77.62,22.38,-53.02,224977,72849,297826,75.54,24.46,-46.54
2008,"IL-06",151647,109352,260999,58.1,41.9,-13.98,181886,130530,312416,58.22,41.78,-11.9
2008,"IL-07",252815,29883,282698,89.43,10.57,-76.64,260622,39001,299623,86.98,13.02,-69.42
2008,"IL-08",160039,134120,294159,54.41,45.59,-6.6,197359,153670,351029,56.22,43.78,-7.9
2008,"IL-09",202898,64400,267298,75.91,24.09,-49.6,223294,83230,306524,72.85,27.15,-41.16
2008,"IL-10",183960,95615,279575,65.8,34.2,-29.38,216794,110977,327771,66.14,33.86,-27.74
2008,"IL-11",146332,169972,316304,46.26,53.74,9.7,169095,195290,364385,46.41,53.59,11.72
2008,"IL-12",121477,159813,281290,43.19,56.81,15.84,132167,169883,302050,43.76,56.24,17.02
2008,"IL-13",193024,149558,342582,56.34,43.66,-10.46,241317,172928,414245,58.25,41.75,-11.96
2008,"IL-14",167847,149231,317078,52.94,47.06,-3.66,209997,173082,383079,54.82,45.18,-5.09999999999999
2008,"IL-15",113774,168361,282135,40.33,59.67,21.56,131103,183848,314951,41.63,58.37,21.28
2008,"IL-16",134685,158605,293290,45.92,54.08,10.38,161126,178551,339677,47.44,52.56,9.66
2008,"IL-17",109618,144000,253618,43.22,56.78,15.78,118435,157397,275832,42.94,57.06,18.66
2008,"IL-18",111048,175807,286855,38.71,61.29,24.8,128725,192080,320805,40.13,59.87,24.28
2008,"IL-19",88884,218574,307458,28.91,71.09,44.4,103380,236828,340208,30.39,69.61,43.76
2010,"IL-01",208330,37828,246158,84.63,15.37,-67.04,201147,44084,245231,82.02,17.98,-59.5
2010,"IL-02",230718,23633,254351,90.71,9.29,-79.2,226220,26570,252790,89.49,10.51,-74.44
2010,"IL-03",160650,83668,244318,65.75,34.25,-29.28,176307,99838,276145,63.85,36.15,-23.16
2010,"IL-04",155596,16653,172249,90.33,9.67,-78.44,167526,26065,193591,86.54,13.46,-68.54
2010,"IL-05",196984,56782,253766,77.62,22.38,-53.02,224977,72849,297826,75.54,24.46,-46.54
2010,"IL-06",151647,109352,260999,58.1,41.9,-13.98,181886,130530,312416,58.22,41.78,-11.9
2010,"IL-07",252815,29883,282698,89.43,10.57,-76.64,260622,39001,299623,86.98,13.02,-69.42
2010,"IL-08",160039,134120,294159,54.41,45.59,-6.6,197359,153670,351029,56.22,43.78,-7.9
2010,"IL-09",202898,64400,267298,75.91,24.09,-49.6,223294,83230,306524,72.85,27.15,-41.16
2010,"IL-10",183960,95615,279575,65.8,34.2,-29.38,216794,110977,327771,66.14,33.86,-27.74
2010,"IL-11",146332,169972,316304,46.26,53.74,9.7,169095,195290,364385,46.41,53.59,11.72
2010,"IL-12",121477,159813,281290,43.19,56.81,15.84,132167,169883,302050,43.76,56.24,17.02
2010,"IL-13",193024,149558,342582,56.34,43.66,-10.46,241317,172928,414245,58.25,41.75,-11.96
2010,"IL-14",167847,149231,317078,52.94,47.06,-3.66,209997,173082,383079,54.82,45.18,-5.09999999999999
2010,"IL-15",113774,168361,282135,40.33,59.67,21.56,131103,183848,314951,41.63,58.37,21.28
2010,"IL-16",134685,158605,293290,45.92,54.08,10.38,161126,178551,339677,47.44,52.56,9.66
2010,"IL-17",109618,144000,253618,43.22,56.78,15.78,118435,157397,275832,42.94,57.06,18.66
2010,"IL-18",111048,175807,286855,38.71,61.29,24.8,128725,192080,320805,40.13,59.87,24.28
2010,"IL-19",88884,218574,307458,28.91,71.09,44.4,103380,236828,340208,30.39,69.61,43.76
2012,"IL-01",245873,69635,315508,77.93,22.07,-53.64,247290,82285,329575,75.03,24.97,-45.52
2012,"IL-02",236783,58052,294835,80.31,19.69,-58.4,236801,64904,301705,78.49,21.51,-52.44
2012,"IL-03",156776,113362,270138,58.04,41.96,-13.86,175107,135208,310315,56.43,43.57,-8.31999999999999
2012,"IL-04",173386,27992,201378,86.1,13.9,-69.98,185805,39833,225638,82.35,17.65,-60.16
2012,"IL-05",231467,78170,309637,74.75,25.25,-47.28,269494,96773,366267,73.58,26.42,-42.62
2012,"IL-06",177396,152726,330122,53.74,46.26,-5.26000000000001,226454,174553,401007,56.47,43.53,-8.39999999999999
2012,"IL-07",268286,28233,296519,90.48,9.52,-78.74,270769,37969,308738,87.7,12.3,-70.86
2012,"IL-08",148452,93132,241584,61.45,38.55,-20.68,172150,113399,285549,60.29,39.71,-16.04
2012,"IL-09",237993,84510,322503,73.8,26.2,-45.38,269504,104244,373748,72.11,27.89,-39.68
2012,"IL-10",178586,93922,272508,65.53,34.47,-28.84,207063,109525,316588,65.4,34.6,-26.26
2012,"IL-11",165500,100189,265689,62.29,37.71,-22.36,196615,115472,312087,63,37,-21.46
2012,"IL-12",126784,173675,300459,42.2,57.8,17.82,137884,184790,322674,42.73,57.27,19.08
2012,"IL-13",140707,158331,299038,47.05,52.95,8.12,157842,169920,327762,48.16,51.84,8.22000000000001
2012,"IL-14",153293,166551,319844,47.93,52.07,6.36000000000001,202759,193016,395775,51.23,48.77,2.08000000000001
2012,"IL-15",78655,226680,305335,25.76,74.24,50.7,88769,246980,335749,26.44,73.56,51.66
2012,"IL-16",119617,173054,292671,40.87,59.13,20.48,140984,196127,337111,41.82,58.18,20.9
2012,"IL-17",134285,136644,270929,49.56,50.44,3.1,146373,151446,297819,49.15,50.85,6.24
2012,"IL-18",116135,210949,327084,35.51,64.49,31.2,139432,230211,369643,37.72,62.28,29.1
2014,"IL-01",245873,69635,315508,77.93,22.07,-53.64,247290,82285,329575,75.03,24.97,-45.52
2014,"IL-02",236783,58052,294835,80.31,19.69,-58.4,236801,64904,301705,78.49,21.51,-52.44
2014,"IL-03",156776,113362,270138,58.04,41.96,-13.86,175107,135208,310315,56.43,43.57,-8.31999999999999
2014,"IL-04",173386,27992,201378,86.1,13.9,-69.98,185805,39833,225638,82.35,17.65,-60.16
2014,"IL-05",231467,78170,309637,74.75,25.25,-47.28,269494,96773,366267,73.58,26.42,-42.62
2014,"IL-06",177399,152729,330128,53.74,46.26,-5.26000000000001,226458,174557,401015,56.47,43.53,-8.39999999999999
2014,"IL-07",268286,28233,296519,90.48,9.52,-78.74,270769,37969,308738,87.7,12.3,-70.86
2014,"IL-08",148433,93117,241550,61.45,38.55,-20.68,172125,113382,285507,60.29,39.71,-16.04
2014,"IL-09",238019,84531,322550,73.79,26.21,-45.36,269540,104271,373811,72.11,27.89,-39.68
2014,"IL-10",178576,93913,272489,65.54,34.46,-28.86,207048,109511,316559,65.41,34.59,-26.28
2014,"IL-11",165493,100182,265675,62.29,37.71,-22.36,196606,115465,312071,63,37,-21.46
2014,"IL-12",126784,173675,300459,42.2,57.8,17.82,137884,184790,322674,42.73,57.27,19.08
2014,"IL-13",140707,158331,299038,47.05,52.95,8.12,157842,169920,327762,48.16,51.84,8.22000000000001
2014,"IL-14",153300,166558,319858,47.93,52.07,6.36000000000001,202768,193023,395791,51.23,48.77,2.08000000000001
2014,"IL-15",78655,226680,305335,25.76,74.24,50.7,88769,246980,335749,26.44,73.56,51.66
2014,"IL-16",119617,173054,292671,40.87,59.13,20.48,140984,196127,337111,41.82,58.18,20.9
2014,"IL-17",134285,136644,270929,49.56,50.44,3.1,146373,151446,297819,49.15,50.85,6.24
2014,"IL-18",116135,210949,327084,35.51,64.49,31.2,139432,230211,369643,37.72,62.28,29.1
2016,"IL-01",245865,69634,315499,77.93,22.07,-53.64,247288,82284,329572,75.03,24.97,-45.52
2016,"IL-02",236799,58053,294852,80.31,19.69,-58.4,236809,64905,301714,78.49,21.51,-52.44
2016,"IL-03",156794,113365,270159,58.04,41.96,-13.86,175127,135212,310339,56.43,43.57,-8.31999999999999
2016,"IL-04",173372,27990,201362,86.1,13.9,-69.98,185789,39830,225619,82.35,17.65,-60.16
2016,"IL-05",231467,78170,309637,74.75,25.25,-47.28,269494,96773,366267,73.58,26.42,-42.62
2016,"IL-06",177413,152740,330153,53.74,46.26,-5.26000000000001,226474,174570,401044,56.47,43.53,-8.39999999999999
2016,"IL-07",268537,28317,296854,90.46,9.54,-78.7,271045,38062,309107,87.69,12.31,-70.84
2016,"IL-08",148433,93117,241550,61.45,38.55,-20.68,172125,113382,285507,60.29,39.71,-16.04
2016,"IL-09",238019,84531,322550,73.79,26.21,-45.36,269540,104271,373811,72.11,27.89,-39.68
2016,"IL-10",178606,93924,272530,65.54,34.46,-28.86,207073,109521,316594,65.41,34.59,-26.28
2016,"IL-11",165492,100181,265673,62.29,37.71,-22.36,196607,115465,312072,63,37,-21.46
2016,"IL-12",126784,173675,300459,42.2,57.8,17.82,137884,184790,322674,42.73,57.27,19.08
2016,"IL-13",140703,158329,299032,47.05,52.95,8.12,157838,169918,327756,48.16,51.84,8.22000000000001
2016,"IL-14",153287,166548,319835,47.93,52.07,6.36000000000001,202751,193010,395761,51.23,48.77,2.08000000000001
2016,"IL-15",78655,226680,305335,25.76,74.24,50.7,88769,246980,335749,26.44,73.56,51.66
2016,"IL-16",119617,173054,292671,40.87,59.13,20.48,140984,196127,337111,41.82,58.18,20.9
2016,"IL-17",134285,136644,270929,49.56,50.44,3.1,146373,151446,297819,49.15,50.85,6.24
2016,"IL-18",116139,210951,327090,35.51,64.49,31.2,139436,230213,369649,37.72,62.28,29.1
2018,"IL-01",245863,69632,315495,77.93,22.07,-53.64,247290,82288,329578,75.03,24.97,-45.52
2018,"IL-02",236799,58053,294852,80.31,19.69,-58.4,236809,64905,301714,78.49,21.51,-52.44
2018,"IL-03",156799,113369,270168,58.04,41.96,-13.86,175131,135215,310346,56.43,43.57,-8.31999999999999
2018,"IL-04",173385,27996,201381,86.1,13.9,-69.98,185796,39831,225627,82.35,17.65,-60.16
2018,"IL-05",231450,78163,309613,74.75,25.25,-47.28,269481,96769,366250,73.58,26.42,-42.62
2018,"IL-06",177414,152743,330157,53.74,46.26,-5.26000000000001,226479,174573,401052,56.47,43.53,-8.39999999999999
2018,"IL-07",268537,28317,296854,90.46,9.54,-78.7,271045,38062,309107,87.69,12.31,-70.84
2018,"IL-08",148434,93115,241549,61.45,38.55,-20.68,172127,113382,285509,60.29,39.71,-16.04
2018,"IL-09",238380,84614,322994,73.8,26.2,-45.38,269936,104350,374286,72.12,27.88,-39.7
2018,"IL-10",178697,93962,272659,65.54,34.46,-28.86,207177,109565,316742,65.41,34.59,-26.28
2018,"IL-11",165489,100180,265669,62.29,37.71,-22.36,196607,115463,312070,63,37,-21.46
2018,"IL-12",126801,173695,300496,42.2,57.8,17.82,137902,184808,322710,42.73,57.27,19.08
2018,"IL-13",140686,158309,298995,47.05,52.95,8.12,157820,169900,327720,48.16,51.84,8.22000000000001
2018,"IL-14",153283,166545,319828,47.93,52.07,6.36000000000001,202736,193000,395736,51.23,48.77,2.08000000000001
2018,"IL-15",78655,226680,305335,25.76,74.24,50.7,88769,246980,335749,26.44,73.56,51.66
2018,"IL-16",119615,173050,292665,40.87,59.13,20.48,140981,196124,337105,41.82,58.18,20.9
2018,"IL-17",134285,136644,270929,49.56,50.44,3.1,146373,151446,297819,49.15,50.85,6.24
2018,"IL-18",116139,210951,327090,35.51,64.49,31.2,139436,230213,369649,37.72,62.28,29.1
2020,"IL-01",245843,69624,315467,77.93,22.07,-53.64,247259,82279,329538,75.03,24.97,-45.52
2020,"IL-02",236815,58055,294870,80.31,19.69,-58.4,236835,64907,301742,78.49,21.51,-52.44
2020,"IL-03",156802,113375,270177,58.04,41.96,-13.86,175139,135224,310363,56.43,43.57,-8.31999999999999
2020,"IL-04",173391,28000,201391,86.1,13.9,-69.98,185803,39836,225639,82.35,17.65,-60.16
2020,"IL-05",231447,78159,309606,74.76,25.24,-47.3,269475,96764,366239,73.58,26.42,-42.62
2020,"IL-06",177427,152773,330200,53.73,46.27,-5.23999999999999,226494,174598,401092,56.47,43.53,-8.39999999999999
2020,"IL-07",268537,28317,296854,90.46,9.54,-78.7,271045,38062,309107,87.69,12.31,-70.84
2020,"IL-08",148447,93122,241569,61.45,38.55,-20.68,172136,113387,285523,60.29,39.71,-16.04
2020,"IL-09",238380,84614,322994,73.8,26.2,-45.38,269936,104350,374286,72.12,27.88,-39.7
2020,"IL-10",178664,93922,272586,65.54,34.46,-28.86,207178,109554,316732,65.41,34.59,-26.28
2020,"IL-11",165514,100192,265706,62.29,37.71,-22.36,196662,115484,312146,63,37,-21.46
2020,"IL-12",126785,173681,300466,42.2,57.8,17.82,137914,184814,322728,42.73,57.27,19.08
2020,"IL-13",140697,158323,299020,47.05,52.95,8.12,157841,169909,327750,48.16,51.84,8.22000000000001
2020,"IL-14",153217,166485,319702,47.92,52.08,6.38,202648,192946,395594,51.23,48.77,2.08000000000001
2020,"IL-15",78665,226686,305351,25.76,74.24,50.7,88778,246994,335772,26.44,73.56,51.66
2020,"IL-16",119586,173037,292623,40.87,59.13,20.48,140953,196107,337060,41.82,58.18,20.9
2020,"IL-17",134328,136663,270991,49.57,50.43,3.08,146413,151459,297872,49.15,50.85,6.24
2020,"IL-18",116107,210930,327037,35.5,64.5,31.22,139391,230193,369584,37.72,62.28,29.1
2022,"IL-01",257939,86334,344273,74.92,25.08,-47.62,260180,104199,364379,71.4,28.6,-38.26
2022,"IL-02",228211,87509,315720,72.28,27.72,-42.34,231776,96979,328755,70.5,29.5,-36.46
2022,"IL-03",184184,65938,250122,73.64,26.36,-45.06,207097,84211,291308,71.09,28.91,-37.64
2022,"IL-04",165340,49532,214872,76.95,23.05,-51.68,175891,62953,238844,73.64,26.36,-42.74
2022,"IL-05",237931,98898,336829,70.64,29.36,-39.06,279516,118148,397664,70.29,29.71,-36.04
2022,"IL-06",180725,151174,331899,54.45,45.55,-6.67999999999999,216059,172918,388977,55.55,44.45,-6.55999999999999
2022,"IL-07",271277,30720,301997,89.83,10.17,-77.44,273822,40715,314537,87.06,12.94,-69.58
2022,"IL-08",157723,112430,270153,58.38,41.62,-14.54,188882,137455,326337,57.88,42.12,-11.22
2022,"IL-09",233134,88247,321381,72.54,27.46,-42.86,265079,108247,373326,71,29,-37.46
2022,"IL-10",186006,112608,298614,62.29,37.71,-22.36,220323,128271,348594,63.2,36.8,-21.86
2022,"IL-11",172054,136920,308974,55.69,44.31,-9.16,215908,157842,373750,57.77,42.23,-11
2022,"IL-12",96133,252458,348591,27.58,72.42,47.06,107037,270998,378035,28.31,71.69,47.92
2022,"IL-13",175417,147062,322479,54.4,45.6,-6.58000000000001,194527,154951,349478,55.66,44.34,-6.77999999999999
2022,"IL-14",157039,130630,287669,54.59,45.41,-6.96,190763,150921,341684,55.83,44.17,-7.11999999999999
2022,"IL-15",103477,245404,348881,29.66,70.34,42.9,117685,270575,388260,30.31,69.69,43.92
2022,"IL-16",126318,212900,339218,37.24,62.76,27.74,153225,238679,391904,39.1,60.9,26.34
2022,"IL-17",157609,137208,294817,53.46,46.54,-4.7,173992,148821,322813,53.9,46.1,-3.26
2008,"IN-01",153750,127040,280790,54.76,45.24,-7.3,167978,152001,319979,52.5,47.5,-0.459999999999994
2008,"IN-02",105624,146363,251987,41.92,58.08,18.38,121699,159589,281288,43.26,56.74,18.02
2008,"IN-03",87942,183414,271356,32.41,67.59,37.4,114366,205306,319672,35.78,64.22,32.98
2008,"IN-04",110678,220997,331675,33.37,66.63,35.48,148820,247548,396368,37.55,62.45,29.44
2008,"IN-05",132452,242635,375087,35.31,64.69,31.6,184254,271572,455826,40.42,59.58,23.7
2008,"IN-06",80225,183544,263769,30.41,69.59,41.4,89740,198412,288152,31.14,68.86,42.26
2008,"IN-07",165204,73427,238631,69.23,30.77,-36.24,186273,75647,261920,71.12,28.88,-37.7
2008,"IN-08",86596,186385,272981,31.72,68.28,38.78,101186,203409,304595,33.22,66.78,38.1
2008,"IN-09",110627,193375,304002,36.39,63.61,29.44,128058,216247,344305,37.19,62.81,30.16
2010,"IN-01",153750,127040,280790,54.76,45.24,-7.3,167978,152001,319979,52.5,47.5,-0.459999999999994
2010,"IN-02",105624,146363,251987,41.92,58.08,18.38,121699,159589,281288,43.26,56.74,18.02
2010,"IN-03",87942,183414,271356,32.41,67.59,37.4,114366,205306,319672,35.78,64.22,32.98
2010,"IN-04",110678,220997,331675,33.37,66.63,35.48,148820,247548,396368,37.55,62.45,29.44
2010,"IN-05",132452,242635,375087,35.31,64.69,31.6,184254,271572,455826,40.42,59.58,23.7
2010,"IN-06",80225,183544,263769,30.41,69.59,41.4,89740,198412,288152,31.14,68.86,42.26
2010,"IN-07",165204,73427,238631,69.23,30.77,-36.24,186273,75647,261920,71.12,28.88,-37.7
2010,"IN-08",86596,186385,272981,31.72,68.28,38.78,101186,203409,304595,33.22,66.78,38.1
2010,"IN-09",110627,193375,304002,36.39,63.61,29.44,128058,216247,344305,37.19,62.81,30.16
2012,"IN-01",162304,124574,286878,56.58,43.42,-10.94,177569,148486,326055,54.46,45.54,-4.37999999999998
2012,"IN-02",99496,163530,263026,37.83,62.17,26.56,116794,178385,295179,39.57,60.43,25.4
2012,"IN-03",87695,189513,277208,31.64,68.36,38.94,112346,211169,323515,34.73,65.27,35.08
2012,"IN-04",91272,194401,285673,31.95,68.05,38.32,117232,220014,337246,34.76,65.24,35.02
2012,"IN-05",150103,193045,343148,43.74,56.26,14.74,200392,209682,410074,48.87,51.13,6.8
2012,"IN-06",82498,204128,286626,28.78,71.22,44.66,96579,228547,325126,29.71,70.29,45.12
2012,"IN-07",156031,95642,251673,62,38,-21.78,177909,99797,277706,64.06,35.94,-23.58
2012,"IN-08",92844,194226,287070,32.34,67.66,37.54,107988,212147,320135,33.73,66.27,37.08
2012,"IN-09",110858,198117,308975,35.88,64.12,30.46,135572,221503,357075,37.97,62.03,28.6
2014,"IN-01",162304,124574,286878,56.58,43.42,-10.94,177569,148486,326055,54.46,45.54,-4.37999999999998
2014,"IN-02",99496,163530,263026,37.83,62.17,26.56,116794,178385,295179,39.57,60.43,25.4
2014,"IN-03",87695,189513,277208,31.64,68.36,38.94,112346,211169,323515,34.73,65.27,35.08
2014,"IN-04",91272,194401,285673,31.95,68.05,38.32,117232,220014,337246,34.76,65.24,35.02
2014,"IN-05",150109,193046,343155,43.74,56.26,14.74,200398,209683,410081,48.87,51.13,6.8
2014,"IN-06",82498,204128,286626,28.78,71.22,44.66,96579,228547,325126,29.71,70.29,45.12
2014,"IN-07",156025,95641,251666,62,38,-21.78,177903,99796,277699,64.06,35.94,-23.58
2014,"IN-08",92844,194226,287070,32.34,67.66,37.54,107988,212147,320135,33.73,66.27,37.08
2014,"IN-09",110858,198117,308975,35.88,64.12,30.46,135572,221503,357075,37.97,62.03,28.6
2016,"IN-01",162358,124638,286996,56.57,43.43,-10.92,177630,148554,326184,54.46,45.54,-4.37999999999998
2016,"IN-02",99496,163530,263026,37.83,62.17,26.56,116794,178385,295179,39.57,60.43,25.4
2016,"IN-03",87695,189513,277208,31.64,68.36,38.94,112346,211169,323515,34.73,65.27,35.08
2016,"IN-04",91272,194401,285673,31.95,68.05,38.32,117232,220014,337246,34.76,65.24,35.02
2016,"IN-05",150109,193046,343155,43.74,56.26,14.74,200398,209683,410081,48.87,51.13,6.8
2016,"IN-06",82498,204128,286626,28.78,71.22,44.66,96579,228547,325126,29.71,70.29,45.12
2016,"IN-07",156025,95641,251666,62,38,-21.78,177903,99796,277699,64.06,35.94,-23.58
2016,"IN-08",92844,194226,287070,32.34,67.66,37.54,107989,212148,320137,33.73,66.27,37.08
2016,"IN-09",110858,198117,308975,35.88,64.12,30.46,135572,221503,357075,37.97,62.03,28.6
2018,"IN-01",162358,124638,286996,56.57,43.43,-10.92,177630,148554,326184,54.46,45.54,-4.37999999999998
2018,"IN-02",99496,163530,263026,37.83,62.17,26.56,116794,178385,295179,39.57,60.43,25.4
2018,"IN-03",87695,189513,277208,31.64,68.36,38.94,112346,211169,323515,34.73,65.27,35.08
2018,"IN-04",91272,194401,285673,31.95,68.05,38.32,117232,220014,337246,34.76,65.24,35.02
2018,"IN-05",150109,193046,343155,43.74,56.26,14.74,200398,209683,410081,48.87,51.13,6.8
2018,"IN-06",82498,204128,286626,28.78,71.22,44.66,96579,228547,325126,29.71,70.29,45.12
2018,"IN-07",156025,95641,251666,62,38,-21.78,177903,99796,277699,64.06,35.94,-23.58
2018,"IN-08",92844,194226,287070,32.34,67.66,37.54,107989,212148,320137,33.73,66.27,37.08
2018,"IN-09",110858,198117,308975,35.88,64.12,30.46,135572,221503,357075,37.97,62.03,28.6
2020,"IN-01",162358,124638,286996,56.57,43.43,-10.92,177630,148554,326184,54.46,45.54,-4.37999999999998
2020,"IN-02",99496,163530,263026,37.83,62.17,26.56,116794,178385,295179,39.57,60.43,25.4
2020,"IN-03",87695,189513,277208,31.64,68.36,38.94,112346,211169,323515,34.73,65.27,35.08
2020,"IN-04",91272,194401,285673,31.95,68.05,38.32,117232,220014,337246,34.76,65.24,35.02
2020,"IN-05",150088,193031,343119,43.74,56.26,14.74,200376,209668,410044,48.87,51.13,6.8
2020,"IN-06",82498,204128,286626,28.78,71.22,44.66,96584,228555,325139,29.71,70.29,45.12
2020,"IN-07",156046,95656,251702,62,38,-21.78,177925,99811,277736,64.06,35.94,-23.58
2020,"IN-08",92841,194221,287062,32.34,67.66,37.54,108025,212185,320210,33.74,66.26,37.06
2020,"IN-09",110853,198113,308966,35.88,64.12,30.46,135586,221516,357102,37.97,62.03,28.6
2022,"IN-01",165951,128962,294913,56.27,43.73,-10.32,181826,153357,335183,54.25,45.75,-3.95999999999999
2022,"IN-02",99814,172779,272593,36.62,63.38,28.98,117711,188035,305746,38.5,61.5,27.54
2022,"IN-03",87873,187834,275707,31.87,68.13,38.48,111628,209802,321430,34.73,65.27,35.08
2022,"IN-04",89726,192861,282587,31.75,68.25,38.72,118432,219088,337520,35.09,64.91,34.36
2022,"IN-05",113697,189752,303449,37.47,62.53,27.28,151361,210080,361441,41.88,58.12,20.78
2022,"IN-06",83846,194428,278274,30.13,69.87,41.96,109408,215368,324776,33.69,66.31,37.16
2022,"IN-07",187176,84028,271204,69.02,30.98,-35.82,213492,84805,298297,71.57,28.43,-38.6
2022,"IN-08",96919,206008,302927,31.99,68.01,38.24,112348,225274,337622,33.28,66.72,37.98
2022,"IN-09",108144,200579,308723,35.03,64.97,32.16,126293,224048,350341,36.05,63.95,32.44
2008,"IA-01",134608,147175,281783,47.77,52.23,6.67999999999999,150159,166577,316736,47.41,52.59,9.72000000000001
2008,"IA-02",157683,141481,299164,52.71,47.29,-3.2,183402,157316,340718,53.83,46.17,-3.11999999999999
2008,"IA-03",155769,159232,315001,49.45,50.55,3.31999999999999,185631,180989,366620,50.63,49.37,3.28000000000002
2008,"IA-04",125096,171606,296702,42.16,57.84,17.9,147422,196742,344164,42.83,57.17,18.88
2008,"IA-05",80513,181489,262002,30.73,69.27,40.76,92439,196042,288481,32.04,67.96,40.46
2010,"IA-01",134608,147175,281783,47.77,52.23,6.67999999999999,150159,166577,316736,47.41,52.59,9.72000000000001
2010,"IA-02",157683,141481,299164,52.71,47.29,-3.2,183402,157316,340718,53.83,46.17,-3.11999999999999
2010,"IA-03",155769,159232,315001,49.45,50.55,3.31999999999999,185631,180989,366620,50.63,49.37,3.28000000000002
2010,"IA-04",125096,171606,296702,42.16,57.84,17.9,147422,196742,344164,42.83,57.17,18.88
2010,"IA-05",80513,181489,262002,30.73,69.27,40.76,92439,196042,288481,32.04,67.96,40.46
2012,"IA-01",176477,190379,366856,48.11,51.89,6,199259,213601,412860,48.26,51.74,8.02
2012,"IA-02",170796,186384,357180,47.82,52.18,6.58000000000001,193437,209858,403295,47.96,52.04,8.62
2012,"IA-03",178937,192960,371897,48.11,51.89,6,224159,224726,448885,49.94,50.06,4.66000000000001
2012,"IA-04",127401,231229,358630,35.52,64.48,31.18,142206,249487,391693,36.31,63.69,31.92
2014,"IA-01",176477,190379,366856,48.11,51.89,6,199259,213601,412860,48.26,51.74,8.02
2014,"IA-02",170796,186384,357180,47.82,52.18,6.58000000000001,193437,209858,403295,47.96,52.04,8.62
2014,"IA-03",178937,192960,371897,48.11,51.89,6,224159,224726,448885,49.94,50.06,4.66000000000001
2014,"IA-04",127401,231229,358630,35.52,64.48,31.18,142206,249487,391693,36.31,63.69,31.92
2016,"IA-01",176477,190379,366856,48.11,51.89,6,199259,213601,412860,48.26,51.74,8.02
2016,"IA-02",170796,186384,357180,47.82,52.18,6.58000000000001,193437,209858,403295,47.96,52.04,8.62
2016,"IA-03",178937,192960,371897,48.11,51.89,6,224159,224726,448885,49.94,50.06,4.66000000000001
2016,"IA-04",127401,231229,358630,35.52,64.48,31.18,142206,249487,391693,36.31,63.69,31.92
2018,"IA-01",176477,190379,366856,48.11,51.89,6,199259,213601,412860,48.26,51.74,8.02
2018,"IA-02",170796,186384,357180,47.82,52.18,6.58000000000001,193437,209858,403295,47.96,52.04,8.62
2018,"IA-03",178937,192960,371897,48.11,51.89,6,224159,224726,448885,49.94,50.06,4.66000000000001
2018,"IA-04",127401,231229,358630,35.52,64.48,31.18,142206,249487,391693,36.31,63.69,31.92
2020,"IA-01",176477,190379,366856,48.11,51.89,6,199259,213601,412860,48.26,51.74,8.02
2020,"IA-02",170796,186384,357180,47.82,52.18,6.58000000000001,193437,209858,403295,47.96,52.04,8.62
2020,"IA-03",178937,192960,371897,48.11,51.89,6,224159,224726,448885,49.94,50.06,4.66000000000001
2020,"IA-04",127401,231229,358630,35.52,64.48,31.18,142206,249487,391693,36.31,63.69,31.92
2022,"IA-01",177850,189883,367733,48.36,51.64,5.5,203400,215742,419142,48.53,51.47,7.48000000000001
2022,"IA-02",180224,198924,379148,47.53,52.47,7.16,203246,222312,425558,47.76,52.24,9.02
2022,"IA-03",165874,177109,342983,48.36,51.64,5.5,205591,207043,412634,49.82,50.18,4.90000000000001
2022,"IA-04",129663,235036,364699,35.55,64.45,31.12,146824,252575,399399,36.76,63.24,31.02
2008,"KS-01",55674,179559,235233,23.67,76.33,54.88,71202,201893,273095,26.07,73.93,52.4
2008,"KS-02",102703,166967,269670,38.08,61.92,26.06,131529,194227,325756,40.38,59.62,23.78
2008,"KS-03",177371,160144,337515,52.55,47.45,-2.88,243650,182804,426454,57.13,42.87,-9.71999999999999
2008,"KS-04",91243,164341,255584,35.7,64.3,30.82,123925,192474,316399,39.17,60.83,26.2
2010,"KS-01",55674,179559,235233,23.67,76.33,54.88,71202,201893,273095,26.07,73.93,52.4
2010,"KS-02",102703,166967,269670,38.08,61.92,26.06,131529,194227,325756,40.38,59.62,23.78
2010,"KS-03",177371,160144,337515,52.55,47.45,-2.88,243650,182804,426454,57.13,42.87,-9.71999999999999
2010,"KS-04",91243,164341,255584,35.7,64.3,30.82,123925,192474,316399,39.17,60.83,26.2
2012,"KS-01",64387,183451,247838,25.98,74.02,50.26,83890,207727,291617,28.77,71.23,47
2012,"KS-02",110598,164997,275595,40.13,59.87,21.96,140303,191030,331333,42.35,57.65,19.84
2012,"KS-03",161465,157297,318762,50.65,49.35,0.920000000000009,223097,179575,402672,55.4,44.6,-6.26
2012,"KS-04",90541,165266,255807,35.39,64.61,31.44,123016,193066,316082,38.92,61.08,26.7
2014,"KS-01",64387,183451,247838,25.98,74.02,50.26,83890,207727,291617,28.77,71.23,47
2014,"KS-02",110598,164997,275595,40.13,59.87,21.96,140303,191030,331333,42.35,57.65,19.84
2014,"KS-03",161465,157297,318762,50.65,49.35,0.920000000000009,223097,179575,402672,55.4,44.6,-6.26
2014,"KS-04",90541,165266,255807,35.39,64.61,31.44,123016,193066,316082,38.92,61.08,26.7
2016,"KS-01",64387,183451,247838,25.98,74.02,50.26,83890,207727,291617,28.77,71.23,47
2016,"KS-02",110598,164997,275595,40.13,59.87,21.96,140303,191030,331333,42.35,57.65,19.84
2016,"KS-03",161465,157297,318762,50.65,49.35,0.920000000000009,223097,179575,402672,55.4,44.6,-6.26
2016,"KS-04",90541,165266,255807,35.39,64.61,31.44,123016,193066,316082,38.92,61.08,26.7
2018,"KS-01",64387,183451,247838,25.98,74.02,50.26,83890,207727,291617,28.77,71.23,47
2018,"KS-02",110598,164997,275595,40.13,59.87,21.96,140303,191030,331333,42.35,57.65,19.84
2018,"KS-03",161465,157297,318762,50.65,49.35,0.920000000000009,223097,179575,402672,55.4,44.6,-6.26
2018,"KS-04",90541,165266,255807,35.39,64.61,31.44,123016,193066,316082,38.92,61.08,26.7
2020,"KS-01",64387,183451,247838,25.98,74.02,50.26,83890,207727,291617,28.77,71.23,47
2020,"KS-02",110598,164997,275595,40.13,59.87,21.96,140303,191030,331333,42.35,57.65,19.84
2020,"KS-03",161465,157297,318762,50.65,49.35,0.920000000000009,223097,179575,402672,55.4,44.6,-6.26
2020,"KS-04",90541,165266,255807,35.39,64.61,31.44,123016,193066,316082,38.92,61.08,26.7
2022,"KS-01",84998,182316,267314,31.8,68.2,38.62,110560,206485,317045,34.87,65.13,34.8
2022,"KS-02",104989,158393,263382,39.86,60.14,22.5,130764,183231,313995,41.65,58.35,21.24
2022,"KS-03",146199,164254,310453,47.09,52.91,8.04000000000001,205663,187747,393410,52.28,47.72,-0.019999999999996
2022,"KS-04",90806,166048,256854,35.35,64.65,31.52,123319,193935,317254,38.87,61.13,26.8
2008,"KY-01",69316,213589,282905,24.5,75.5,53.22,79650,230255,309905,25.7,74.3,53.14
2008,"KY-02",95820,228042,323862,29.59,70.41,43.04,119104,258849,377953,31.51,68.49,41.52
2008,"KY-03",187904,140073,327977,57.29,42.71,-12.36,224610,146727,371337,60.49,39.51,-16.44
2008,"KY-04",95532,219884,315416,30.29,69.71,41.64,126856,255608,382464,33.17,66.83,38.2
2008,"KY-05",44608,206041,250649,17.8,82.2,66.62,51252,223823,275075,18.63,81.37,67.28
2008,"KY-06",135663,195321,330984,40.99,59.01,20.24,170742,210880,381622,44.74,55.26,15.06
2010,"KY-01",69316,213589,282905,24.5,75.5,53.22,79650,230255,309905,25.7,74.3,53.14
2010,"KY-02",95820,228042,323862,29.59,70.41,43.04,119104,258849,377953,31.51,68.49,41.52
2010,"KY-03",187904,140073,327977,57.29,42.71,-12.36,224610,146727,371337,60.49,39.51,-16.44
2010,"KY-04",95532,219884,315416,30.29,69.71,41.64,126856,255608,382464,33.17,66.83,38.2
2010,"KY-05",44608,206041,250649,17.8,82.2,66.62,51252,223823,275075,18.63,81.37,67.28
2010,"KY-06",135663,195321,330984,40.99,59.01,20.24,170742,210880,381622,44.74,55.26,15.06
2012,"KY-01",74175,224647,298822,24.82,75.18,52.58,85273,244212,329485,25.88,74.12,52.78
2012,"KY-02",89563,219152,308715,29.01,70.99,44.2,113098,250037,363135,31.14,68.86,42.26
2012,"KY-03",186550,135709,322259,57.89,42.11,-13.56,221551,140624,362175,61.17,38.83,-17.8
2012,"KY-04",98662,219754,318416,30.99,69.01,40.24,125370,242133,367503,34.11,65.89,36.32
2012,"KY-05",48625,221551,270176,18,82,66.22,59907,248084,307991,19.45,80.55,65.64
2012,"KY-06",131268,182137,313405,41.88,58.12,18.46,167015,201051,368066,45.38,54.62,13.78
2014,"KY-01",74175,224647,298822,24.82,75.18,52.58,85273,244212,329485,25.88,74.12,52.78
2014,"KY-02",89563,219152,308715,29.01,70.99,44.2,113098,250037,363135,31.14,68.86,42.26
2014,"KY-03",186550,135709,322259,57.89,42.11,-13.56,221551,140624,362175,61.17,38.83,-17.8
2014,"KY-04",98662,219754,318416,30.99,69.01,40.24,125370,242133,367503,34.11,65.89,36.32
2014,"KY-05",48625,221551,270176,18,82,66.22,59907,248084,307991,19.45,80.55,65.64
2014,"KY-06",131268,182137,313405,41.88,58.12,18.46,167015,201051,368066,45.38,54.62,13.78
2016,"KY-01",74179,224654,298833,24.82,75.18,52.58,85273,244212,329485,25.88,74.12,52.78
2016,"KY-02",89563,219152,308715,29.01,70.99,44.2,113098,250037,363135,31.14,68.86,42.26
2016,"KY-03",186550,135709,322259,57.89,42.11,-13.56,221551,140624,362175,61.17,38.83,-17.8
2016,"KY-04",98662,219754,318416,30.99,69.01,40.24,125370,242133,367503,34.11,65.89,36.32
2016,"KY-05",48625,221551,270176,18,82,66.22,59907,248084,307991,19.45,80.55,65.64
2016,"KY-06",131268,182137,313405,41.88,58.12,18.46,167015,201051,368066,45.38,54.62,13.78
2018,"KY-01",74179,224654,298833,24.82,75.18,52.58,85273,244212,329485,25.88,74.12,52.78
2018,"KY-02",89563,219152,308715,29.01,70.99,44.2,113098,250037,363135,31.14,68.86,42.26
2018,"KY-03",186550,135709,322259,57.89,42.11,-13.56,221551,140624,362175,61.17,38.83,-17.8
2018,"KY-04",98662,219754,318416,30.99,69.01,40.24,125370,242133,367503,34.11,65.89,36.32
2018,"KY-05",48625,221551,270176,18,82,66.22,59907,248084,307991,19.45,80.55,65.64
2018,"KY-06",131268,182137,313405,41.88,58.12,18.46,167015,201051,368066,45.38,54.62,13.78
2020,"KY-01",74155,224641,298796,24.82,75.18,52.58,85273,244212,329485,25.88,74.12,52.78
2020,"KY-02",89561,219148,308709,29.01,70.99,44.2,113098,250037,363135,31.14,68.86,42.26
2020,"KY-03",186536,135699,322235,57.89,42.11,-13.56,221537,140618,362155,61.17,38.83,-17.8
2020,"KY-04",98656,219741,318397,30.99,69.01,40.24,125370,242133,367503,34.11,65.89,36.32
2020,"KY-05",48625,221551,270176,18,82,66.22,59907,248084,307991,19.45,80.55,65.64
2020,"KY-06",131268,182137,313405,41.88,58.12,18.46,167015,201051,368066,45.38,54.62,13.78
2022,"KY-01",84392,228495,312887,26.97,73.03,48.28,99151,251538,350689,28.27,71.73,48
2022,"KY-02",86987,211575,298562,29.14,70.86,43.94,109567,239632,349199,31.38,68.62,41.78
2022,"KY-03",185030,132641,317671,58.25,41.75,-14.28,219506,137467,356973,61.49,38.51,-18.44
2022,"KY-04",94525,214936,309461,30.55,69.45,41.12,123055,245400,368455,33.4,66.6,37.74
2022,"KY-05",55754,236516,292270,19.08,80.92,64.06,63739,256590,320329,19.9,80.1,64.74
2022,"KY-06",122113,178754,300867,40.59,59.41,21.04,157182,195509,352691,44.57,55.43,15.4
2008,"LA-01",91586,222298,313884,29.18,70.82,43.86,112815,238455,351270,32.12,67.88,40.3
2008,"LA-02",166679,39787,206466,80.73,19.27,-59.24,182518,43655,226173,80.7,19.3,-56.86
2008,"LA-03",95222,181869,277091,34.36,65.64,33.5,102517,199494,302011,33.94,66.06,36.66
2008,"LA-04",101426,167275,268701,37.75,62.25,26.72,106080,174852,280932,37.76,62.24,29.02
2008,"LA-05",94497,179355,273852,34.51,65.49,33.2,97045,187037,284082,34.16,65.84,36.22
2008,"LA-06",137016,183689,320705,42.72,57.28,16.78,154585,196943,351528,43.98,56.02,16.58
2008,"LA-07",93728,204365,298093,31.44,68.56,39.34,100474,215340,315814,31.81,68.19,40.92
2010,"LA-01",91586,222298,313884,29.18,70.82,43.86,112815,238455,351270,32.12,67.88,40.3
2010,"LA-02",166679,39787,206466,80.73,19.27,-59.24,182518,43655,226173,80.7,19.3,-56.86
2010,"LA-03",95222,181869,277091,34.36,65.64,33.5,102517,199494,302011,33.94,66.06,36.66
2010,"LA-04",101426,167275,268701,37.75,62.25,26.72,106080,174852,280932,37.76,62.24,29.02
2010,"LA-05",94497,179355,273852,34.51,65.49,33.2,97045,187037,284082,34.16,65.84,36.22
2010,"LA-06",137016,183689,320705,42.72,57.28,16.78,154585,196943,351528,43.98,56.02,16.58
2010,"LA-07",93728,204365,298093,31.44,68.56,39.34,100474,215340,315814,31.81,68.19,40.92
2012,"LA-01",95164,244851,340015,27.99,72.01,46.24,115216,263508,378724,30.42,69.58,43.7
2012,"LA-02",247510,73767,321277,77.04,22.96,-51.86,272285,82133,354418,76.83,23.17,-49.12
2012,"LA-03",100242,231017,331259,30.26,69.74,41.7,107515,242924,350439,30.68,69.32,43.18
2012,"LA-04",116596,192976,309572,37.66,62.34,26.9,121184,201490,322674,37.56,62.44,29.42
2012,"LA-05",110259,205261,315520,34.95,65.05,32.32,114243,215729,329972,34.62,65.38,35.3
2012,"LA-06",110383,230766,341149,32.36,67.64,37.5,125591,249992,375583,33.44,66.56,37.66
2014,"LA-01",95164,244851,340015,27.99,72.01,46.24,115216,263508,378724,30.42,69.58,43.7
2014,"LA-02",247510,73767,321277,77.04,22.96,-51.86,272285,82133,354418,76.83,23.17,-49.12
2014,"LA-03",100242,231017,331259,30.26,69.74,41.7,107515,242924,350439,30.68,69.32,43.18
2014,"LA-04",116596,192976,309572,37.66,62.34,26.9,121184,201490,322674,37.56,62.44,29.42
2014,"LA-05",110259,205261,315520,34.95,65.05,32.32,114243,215729,329972,34.62,65.38,35.3
2014,"LA-06",110383,230766,341149,32.36,67.64,37.5,125591,249992,375583,33.44,66.56,37.66
2016,"LA-01",95163,244847,340010,27.99,72.01,46.24,115216,263508,378724,30.42,69.58,43.7
2016,"LA-02",247511,73771,321282,77.04,22.96,-51.86,272285,82133,354418,76.83,23.17,-49.12
2016,"LA-03",100242,231017,331259,30.26,69.74,41.7,107515,242924,350439,30.68,69.32,43.18
2016,"LA-04",116596,192976,309572,37.66,62.34,26.9,121184,201490,322674,37.56,62.44,29.42
2016,"LA-05",110259,205261,315520,34.95,65.05,32.32,114243,215729,329972,34.62,65.38,35.3
2016,"LA-06",110383,230766,341149,32.36,67.64,37.5,125591,249992,375583,33.44,66.56,37.66
2018,"LA-01",95155,244838,339993,27.99,72.01,46.24,115205,263503,378708,30.42,69.58,43.7
2018,"LA-02",247519,73780,321299,77.04,22.96,-51.86,272296,82138,354434,76.83,23.17,-49.12
2018,"LA-03",100242,231017,331259,30.26,69.74,41.7,107515,242924,350439,30.68,69.32,43.18
2018,"LA-04",116596,192976,309572,37.66,62.34,26.9,121184,201490,322674,37.56,62.44,29.42
2018,"LA-05",110259,205261,315520,34.95,65.05,32.32,114243,215729,329972,34.62,65.38,35.3
2018,"LA-06",110383,230766,341149,32.36,67.64,37.5,125591,249992,375583,33.44,66.56,37.66
2020,"LA-01",95196,244829,340025,28,72,46.22,115191,263488,378679,30.42,69.58,43.7
2020,"LA-02",247470,73803,321273,77.03,22.97,-51.84,272319,82141,354460,76.83,23.17,-49.12
2020,"LA-03",100242,231017,331259,30.26,69.74,41.7,107521,242939,350460,30.68,69.32,43.18
2020,"LA-04",116596,192981,309577,37.66,62.34,26.9,121177,201470,322647,37.56,62.44,29.42
2020,"LA-05",110259,205256,315515,34.95,65.05,32.32,114244,215734,329978,34.62,65.38,35.3
2020,"LA-06",110391,230752,341143,32.36,67.64,37.5,125582,250004,375586,33.44,66.56,37.66
2022,"LA-01",89444,237662,327106,27.34,72.66,47.54,109244,256598,365842,29.86,70.14,44.82
2022,"LA-02",247393,73776,321169,77.03,22.97,-51.84,272476,82065,354541,76.85,23.15,-49.16
2022,"LA-03",99496,227858,327354,30.39,69.61,41.44,106734,239328,346062,30.84,69.16,42.86
2022,"LA-04",126164,205744,331908,38.01,61.99,26.2,130826,215522,346348,37.77,62.23,29
2022,"LA-05",116433,214131,330564,35.22,64.78,31.78,120691,224741,345432,34.94,65.06,34.66
2022,"LA-06",101223,219467,320690,31.56,68.44,39.1,116063,237522,353585,32.82,67.18,38.9
2008,"ME-01",213306,158333,371639,57.4,42.6,-12.58,267120,168562,435682,61.31,38.69,-18.08
2008,"ME-02",144429,177260,321689,44.9,55.1,12.42,167950,192205,360155,46.63,53.37,11.28
2010,"ME-01",213306,158333,371639,57.4,42.6,-12.58,267120,168562,435682,61.31,38.69,-18.08
2010,"ME-02",144429,177260,321689,44.9,55.1,12.42,167950,192205,360155,46.63,53.37,11.28
2012,"ME-01",212778,154430,367208,57.94,42.06,-13.66,266409,164048,430457,61.89,38.11,-19.24
2012,"ME-02",144957,181163,326120,44.45,55.55,13.32,168661,196719,365380,46.16,53.84,12.22
2014,"ME-01",212778,154430,367208,57.94,42.06,-13.66,266409,164048,430457,61.89,38.11,-19.24
2014,"ME-02",144957,181163,326120,44.45,55.55,13.32,168661,196719,365380,46.16,53.84,12.22
2016,"ME-01",212778,154430,367208,57.94,42.06,-13.66,266409,164048,430457,61.89,38.11,-19.24
2016,"ME-02",144957,181163,326120,44.45,55.55,13.32,168661,196719,365380,46.16,53.84,12.22
2018,"ME-01",212778,154430,367208,57.94,42.06,-13.66,266409,164048,430457,61.89,38.11,-19.24
2018,"ME-02",144957,181163,326120,44.45,55.55,13.32,168661,196719,365380,46.16,53.84,12.22
2020,"ME-01",212778,154430,367208,57.94,42.06,-13.66,266409,164048,430457,61.89,38.11,-19.24
2020,"ME-02",144957,181163,326120,44.45,55.55,13.32,168661,196719,365380,46.16,53.84,12.22
2022,"ME-01",205601,150452,356053,57.74,42.26,-13.26,258033,159936,417969,61.73,38.27,-18.92
2022,"ME-02",152134,185141,337275,45.11,54.89,12,177037,200831,377868,46.85,53.15,10.84
2008,"MD-01",137071,220794,357865,38.3,61.7,25.62,177161,231450,408611,43.36,56.64,17.82
2008,"MD-02",178569,118434,297003,60.12,39.88,-18.02,207065,115006,322071,64.29,35.71,-24.04
2008,"MD-03",214479,113768,328247,65.34,34.66,-28.46,262034,113674,375708,69.74,30.26,-34.94
2008,"MD-04",284444,37982,322426,88.22,11.78,-74.22,316897,43693,360590,87.88,12.12,-71.22
2008,"MD-05",240256,118778,359034,66.92,33.08,-31.62,292905,123371,416276,70.36,29.64,-36.18
2008,"MD-06",131162,222331,353493,37.1,62.9,28.02,174381,229068,403449,43.22,56.78,18.1
2008,"MD-07",222899,49549,272448,81.81,18.19,-61.4,247698,53203,300901,82.32,17.68,-60.1
2008,"MD-08",267383,59456,326839,81.81,18.19,-61.4,305055,65166,370221,82.4,17.6,-60.26
2010,"MD-01",137071,220794,357865,38.3,61.7,25.62,177161,231450,408611,43.36,56.64,17.82
2010,"MD-02",178569,118434,297003,60.12,39.88,-18.02,207065,115006,322071,64.29,35.71,-24.04
2010,"MD-03",214479,113768,328247,65.34,34.66,-28.46,262034,113674,375708,69.74,30.26,-34.94
2010,"MD-04",284444,37982,322426,88.22,11.78,-74.22,316897,43693,360590,87.88,12.12,-71.22
2010,"MD-05",240256,118778,359034,66.92,33.08,-31.62,292905,123371,416276,70.36,29.64,-36.18
2010,"MD-06",131162,222331,353493,37.1,62.9,28.02,174381,229068,403449,43.22,56.78,18.1
2010,"MD-07",222899,49549,272448,81.81,18.19,-61.4,247698,53203,300901,82.32,17.68,-60.1
2010,"MD-08",267383,59456,326839,81.81,18.19,-61.4,305055,65166,370221,82.4,17.6,-60.26
2012,"MD-01",121866,225204,347070,35.11,64.89,32,157412,236809,394221,39.93,60.07,24.68
2012,"MD-02",193216,114478,307694,62.79,37.21,-23.36,225407,110905,336312,67.02,32.98,-29.5
2012,"MD-03",221668,113231,334899,66.19,33.81,-30.16,262849,112248,375097,70.07,29.93,-35.6
2012,"MD-04",256484,63415,319899,80.18,19.82,-58.14,286674,69568,356242,80.47,19.53,-56.4
2012,"MD-05",226099,115891,341990,66.11,33.89,-30,277028,119785,396813,69.81,30.19,-35.08
2012,"MD-06",189605,134882,324487,58.43,41.57,-14.64,227313,140789,368102,61.75,38.25,-18.96
2012,"MD-07",233830,63487,297317,78.65,21.35,-55.08,261269,66778,328047,79.64,20.36,-54.74
2012,"MD-08",235105,112560,347665,67.62,32.38,-33.02,286982,119473,406455,70.61,29.39,-36.68
2014,"MD-01",121866,225204,347070,35.11,64.89,32,157412,236809,394221,39.93,60.07,24.68
2014,"MD-02",193216,114478,307694,62.79,37.21,-23.36,225407,110905,336312,67.02,32.98,-29.5
2014,"MD-03",221668,113231,334899,66.19,33.81,-30.16,262849,112248,375097,70.07,29.93,-35.6
2014,"MD-04",256500,63417,319917,80.18,19.82,-58.14,286685,69570,356255,80.47,19.53,-56.4
2014,"MD-05",226099,115891,341990,66.11,33.89,-30,277028,119785,396813,69.81,30.19,-35.08
2014,"MD-06",189604,134881,324485,58.43,41.57,-14.64,227309,140789,368098,61.75,38.25,-18.96
2014,"MD-07",233830,63487,297317,78.65,21.35,-55.08,261269,66778,328047,79.64,20.36,-54.74
2014,"MD-08",235090,112559,347649,67.62,32.38,-33.02,286975,119472,406447,70.61,29.39,-36.68
2016,"MD-01",121868,225205,347073,35.11,64.89,32,157418,236811,394229,39.93,60.07,24.68
2016,"MD-02",193214,114477,307691,62.79,37.21,-23.36,225401,110903,336304,67.02,32.98,-29.5
2016,"MD-03",221668,113231,334899,66.19,33.81,-30.16,262849,112248,375097,70.07,29.93,-35.6
2016,"MD-04",256500,63417,319917,80.18,19.82,-58.14,286685,69570,356255,80.47,19.53,-56.4
2016,"MD-05",226099,115891,341990,66.11,33.89,-30,277028,119785,396813,69.81,30.19,-35.08
2016,"MD-06",189624,134887,324511,58.43,41.57,-14.64,227336,140796,368132,61.75,38.25,-18.96
2016,"MD-07",233830,63487,297317,78.65,21.35,-55.08,261269,66778,328047,79.64,20.36,-54.74
2016,"MD-08",235023,112550,347573,67.62,32.38,-33.02,286884,119461,406345,70.6,29.4,-36.66
2018,"MD-01",121868,225205,347073,35.11,64.89,32,157418,236811,394229,39.93,60.07,24.68
2018,"MD-02",193214,114477,307691,62.79,37.21,-23.36,225401,110903,336304,67.02,32.98,-29.5
2018,"MD-03",221668,113231,334899,66.19,33.81,-30.16,262849,112248,375097,70.07,29.93,-35.6
2018,"MD-04",256514,63418,319932,80.18,19.82,-58.14,286685,69570,356255,80.47,19.53,-56.4
2018,"MD-05",226085,115890,341975,66.11,33.89,-30,277028,119785,396813,69.81,30.19,-35.08
2018,"MD-06",189624,134887,324511,58.43,41.57,-14.64,227336,140796,368132,61.75,38.25,-18.96
2018,"MD-07",233830,63487,297317,78.65,21.35,-55.08,261269,66778,328047,79.64,20.36,-54.74
2018,"MD-08",235023,112550,347573,67.62,32.38,-33.02,286884,119461,406345,70.6,29.4,-36.66
2020,"MD-01",121868,225205,347073,35.11,64.89,32,157425,236823,394248,39.93,60.07,24.68
2020,"MD-02",193214,114464,307678,62.8,37.2,-23.38,225396,110892,336288,67.02,32.98,-29.5
2020,"MD-03",221698,113274,334972,66.18,33.82,-30.14,262904,112292,375196,70.07,29.93,-35.6
2020,"MD-04",256439,63379,319818,80.18,19.82,-58.14,286605,69532,356137,80.48,19.52,-56.42
2020,"MD-05",226103,115894,341997,66.11,33.89,-30,277028,119785,396813,69.81,30.19,-35.08
2020,"MD-06",189591,134874,324465,58.43,41.57,-14.64,227290,140780,368070,61.75,38.25,-18.96
2020,"MD-07",233857,63492,297349,78.65,21.35,-55.08,261301,66783,328084,79.64,20.36,-54.74
2020,"MD-08",235056,112563,347619,67.62,32.38,-33.02,286930,119477,406407,70.6,29.4,-36.66
2022,"MD-01",133897,220681,354578,37.76,62.24,26.7,171268,230939,402207,42.58,57.42,19.38
2022,"MD-02",193692,152441,346133,55.96,44.04,-9.7,232558,150950,383508,60.64,39.36,-16.74
2022,"MD-03",197981,147155,345136,57.36,42.64,-12.5,255359,149862,405221,63.02,36.98,-21.5
2022,"MD-04",269995,22490,292485,92.31,7.69,-82.4,270917,26174,297091,91.19,8.81,-77.84
2022,"MD-05",205794,122472,328266,62.69,37.31,-23.16,281466,128754,410220,68.61,31.39,-32.68
2022,"MD-06",160495,156649,317144,50.61,49.39,1,200303,163843,364146,55.01,44.99,-5.48
2022,"MD-07",240777,54535,295312,81.53,18.47,-60.84,251601,54326,305927,82.24,17.76,-59.94
2022,"MD-08",275173,66704,341877,80.49,19.51,-58.76,321373,71493,392866,81.8,18.2,-59.06
2008,"MA-01",179265,112968,292233,61.34,38.66,-20.46,213723,121694,335417,63.72,36.28,-22.9
2008,"MA-02",167933,127836,295769,56.78,43.22,-11.34,200274,139359,339633,58.97,41.03,-13.4
2008,"MA-03",178157,117424,295581,60.27,39.73,-18.32,219141,128766,347907,62.99,37.01,-21.44
2008,"MA-04",193917,112033,305950,63.38,36.62,-24.54,227898,124721,352619,64.63,35.37,-24.72
2008,"MA-05",193514,114068,307582,62.91,37.09,-23.6,232789,122142,354931,65.59,34.41,-26.64
2008,"MA-06",204551,133196,337747,60.56,39.44,-18.9,253208,138426,391634,64.65,35.35,-24.76
2008,"MA-07",217853,87258,305111,71.4,28.6,-40.58,255807,88705,344512,74.25,25.75,-43.96
2008,"MA-08",240573,26680,267253,90.02,9.98,-77.82,259649,32057,291706,89.01,10.99,-73.48
2008,"MA-09",216207,108028,324235,66.68,33.32,-31.14,261069,113863,374932,69.63,30.37,-34.72
2008,"MA-10",203226,151402,354628,57.31,42.69,-12.4,258644,157469,416113,62.16,37.84,-19.78
2010,"MA-01",179265,112968,292233,61.34,38.66,-20.46,213723,121694,335417,63.72,36.28,-22.9
2010,"MA-02",167933,127836,295769,56.78,43.22,-11.34,200274,139359,339633,58.97,41.03,-13.4
2010,"MA-03",178157,117424,295581,60.27,39.73,-18.32,219141,128766,347907,62.99,37.01,-21.44
2010,"MA-04",193917,112033,305950,63.38,36.62,-24.54,227898,124721,352619,64.63,35.37,-24.72
2010,"MA-05",193514,114068,307582,62.91,37.09,-23.6,232789,122142,354931,65.59,34.41,-26.64
2010,"MA-06",204551,133196,337747,60.56,39.44,-18.9,253208,138426,391634,64.65,35.35,-24.76
2010,"MA-07",217853,87258,305111,71.4,28.6,-40.58,255807,88705,344512,74.25,25.75,-43.96
2010,"MA-08",240573,26680,267253,90.02,9.98,-77.82,259649,32057,291706,89.01,10.99,-73.48
2010,"MA-09",216207,108028,324235,66.68,33.32,-31.14,261069,113863,374932,69.63,30.37,-34.72
2010,"MA-10",203226,151402,354628,57.31,42.69,-12.4,258644,157469,416113,62.16,37.84,-19.78
2012,"MA-01",194035,123950,317985,61.02,38.98,-19.82,224937,135652,360589,62.38,37.62,-20.22
2012,"MA-02",197493,129440,326933,60.41,39.59,-18.6,240549,140380,380929,63.15,36.85,-21.76
2012,"MA-03",202922,123344,326266,62.2,37.8,-22.18,243277,132751,376028,64.7,35.3,-24.86
2012,"MA-04",225880,133697,359577,62.82,37.18,-23.42,276706,144644,421350,65.67,34.33,-26.8
2012,"MA-05",258873,95910,354783,72.97,27.03,-43.72,304034,97550,401584,75.71,24.29,-46.88
2012,"MA-06",224888,153242,378130,59.47,40.53,-16.72,279809,159253,439062,63.73,36.27,-22.92
2012,"MA-07",253502,35937,289439,87.58,12.42,-72.94,275502,42986,318488,86.5,13.5,-68.46
2012,"MA-08",231892,131608,363500,63.79,36.21,-25.36,284007,137725,421732,67.34,32.66,-30.14
2012,"MA-09",205697,163764,369461,55.67,44.33,-9.11999999999999,253365,176260,429625,58.97,41.03,-13.4
2014,"MA-01",194035,123950,317985,61.02,38.98,-19.82,224937,135652,360589,62.38,37.62,-20.22
2014,"MA-02",197493,129440,326933,60.41,39.59,-18.6,240549,140380,380929,63.15,36.85,-21.76
2014,"MA-03",202922,123344,326266,62.2,37.8,-22.18,243277,132751,376028,64.7,35.3,-24.86
2014,"MA-04",225880,133697,359577,62.82,37.18,-23.42,276706,144644,421350,65.67,34.33,-26.8
2014,"MA-05",258873,95910,354783,72.97,27.03,-43.72,304034,97550,401584,75.71,24.29,-46.88
2014,"MA-06",224888,153242,378130,59.47,40.53,-16.72,279809,159253,439062,63.73,36.27,-22.92
2014,"MA-07",253516,35938,289454,87.58,12.42,-72.94,275517,42987,318504,86.5,13.5,-68.46
2014,"MA-08",231892,131608,363500,63.79,36.21,-25.36,284007,137725,421732,67.34,32.66,-30.14
2014,"MA-09",205697,163764,369461,55.67,44.33,-9.11999999999999,253365,176260,429625,58.97,41.03,-13.4
2016,"MA-01",194001,123913,317914,61.02,38.98,-19.82,224894,135614,360508,62.38,37.62,-20.22
2016,"MA-02",197492,129437,326929,60.41,39.59,-18.6,240547,140377,380924,63.15,36.85,-21.76
2016,"MA-03",202935,123333,326268,62.2,37.8,-22.18,243283,132741,376024,64.7,35.3,-24.86
2016,"MA-04",225944,133672,359616,62.83,37.17,-23.44,276769,144619,421388,65.68,34.32,-26.82
2016,"MA-05",258887,95912,354799,72.97,27.03,-43.72,304048,97553,401601,75.71,24.29,-46.88
2016,"MA-06",224851,153237,378088,59.47,40.53,-16.72,279772,159243,439015,63.73,36.27,-22.92
2016,"MA-07",253411,35929,289340,87.58,12.42,-72.94,275409,42975,318384,86.5,13.5,-68.46
2016,"MA-08",231888,131604,363492,63.79,36.21,-25.36,283997,137721,421718,67.34,32.66,-30.14
2016,"MA-09",205697,163764,369461,55.67,44.33,-9.11999999999999,253365,176260,429625,58.97,41.03,-13.4
2018,"MA-01",194001,123913,317914,61.02,38.98,-19.82,224894,135614,360508,62.38,37.62,-20.22
2018,"MA-02",197492,129437,326929,60.41,39.59,-18.6,240547,140377,380924,63.15,36.85,-21.76
2018,"MA-03",202935,123333,326268,62.2,37.8,-22.18,243283,132741,376024,64.7,35.3,-24.86
2018,"MA-04",225959,133676,359635,62.83,37.17,-23.44,276787,144623,421410,65.68,34.32,-26.82
2018,"MA-05",258862,95906,354768,72.97,27.03,-43.72,304019,97547,401566,75.71,24.29,-46.88
2018,"MA-06",224851,153237,378088,59.47,40.53,-16.72,279772,159243,439015,63.73,36.27,-22.92
2018,"MA-07",253407,35930,289337,87.58,12.42,-72.94,275407,42976,318383,86.5,13.5,-68.46
2018,"MA-08",231902,131605,363507,63.8,36.2,-25.38,284010,137722,421732,67.34,32.66,-30.14
2018,"MA-09",205697,163764,369461,55.67,44.33,-9.11999999999999,253365,176260,429625,58.97,41.03,-13.4
2020,"MA-01",194001,123913,317914,61.02,38.98,-19.82,224894,135614,360508,62.38,37.62,-20.22
2020,"MA-02",197492,129437,326929,60.41,39.59,-18.6,240547,140377,380924,63.15,36.85,-21.76
2020,"MA-03",202935,123333,326268,62.2,37.8,-22.18,243283,132741,376024,64.7,35.3,-24.86
2020,"MA-04",225959,133676,359635,62.83,37.17,-23.44,276787,144623,421410,65.68,34.32,-26.82
2020,"MA-05",258862,95906,354768,72.97,27.03,-43.72,304019,97547,401566,75.71,24.29,-46.88
2020,"MA-06",224851,153237,378088,59.47,40.53,-16.72,279772,159243,439015,63.73,36.27,-22.92
2020,"MA-07",253407,35930,289337,87.58,12.42,-72.94,275407,42976,318383,86.5,13.5,-68.46
2020,"MA-08",231902,131605,363507,63.8,36.2,-25.38,284010,137722,421732,67.34,32.66,-30.14
2020,"MA-09",205697,163764,369461,55.67,44.33,-9.11999999999999,253365,176260,429625,58.97,41.03,-13.4
2022,"MA-01",201038,136938,337976,59.48,40.52,-16.74,234928,149796,384724,61.06,38.94,-17.58
2022,"MA-02",209485,123469,332954,62.92,37.08,-23.62,255017,133002,388019,65.72,34.28,-26.9
2022,"MA-03",195060,121650,316710,61.59,38.41,-20.96,233313,131147,364460,64.02,35.98,-23.5
2022,"MA-04",217927,132647,350574,62.16,37.84,-22.1,263771,145237,409008,64.49,35.51,-24.44
2022,"MA-05",255250,92790,348040,73.34,26.66,-44.46,298636,94356,392992,75.99,24.01,-47.44
2022,"MA-06",227657,152981,380638,59.81,40.19,-17.4,283247,158955,442202,64.05,35.95,-23.56
2022,"MA-07",247709,34554,282263,87.76,12.24,-73.3,269476,41257,310733,86.72,13.28,-68.9
2022,"MA-08",228453,124267,352720,64.77,35.23,-27.32,277536,130399,407935,68.03,31.97,-31.52
2022,"MA-09",212527,171505,384032,55.34,44.66,-8.46000000000001,266161,182955,449116,59.26,40.74,-13.98
2008,"MI-01",111713,193304,305017,36.63,63.37,28.96,140154,226272,366426,38.25,61.75,28.04
2008,"MI-02",125015,204490,329505,37.94,62.06,26.34,165867,242557,408424,40.61,59.39,23.32
2008,"MI-03",151268,175427,326695,46.3,53.7,9.62,204112,199704,403816,50.55,49.45,3.44000000000001
2008,"MI-04",121750,188494,310244,39.24,60.76,23.74,153663,222759,376422,40.82,59.18,22.9
2008,"MI-05",145485,130366,275851,52.74,47.26,-3.25999999999999,168362,152078,320440,52.54,47.46,-0.539999999999992
2008,"MI-06",136542,157832,294374,46.38,53.62,9.46000000000001,171950,182683,354633,48.49,51.51,7.56
2008,"MI-07",128889,172705,301594,42.74,57.26,16.74,160583,201760,362343,44.32,55.68,15.9
2008,"MI-08",161115,188967,350082,46.02,53.98,10.18,206827,217075,423902,48.79,51.21,6.96000000000001
2008,"MI-09",189747,153727,343474,55.24,44.76,-8.26000000000001,239560,169850,409410,58.51,41.49,-12.48
2008,"MI-10",117458,229771,347229,33.83,66.17,34.56,152479,275432,427911,35.63,64.37,33.28
2008,"MI-11",179086,173745,352831,50.76,49.24,0.699999999999996,235579,195767,431346,54.61,45.39,-4.67999999999999
2008,"MI-12",184133,118011,302144,60.94,39.06,-19.66,221471,135671,357142,62.01,37.99,-19.48
2008,"MI-13",146867,33014,179881,81.65,18.35,-61.08,158101,38981,197082,80.22,19.78,-55.9
2008,"MI-14",176826,38520,215346,82.11,17.89,-62,191265,46334,237599,80.5,19.5,-56.46
2008,"MI-15",192946,121170,314116,61.43,38.57,-20.64,234023,142892,376915,62.09,37.91,-19.64
2010,"MI-01",111713,193304,305017,36.63,63.37,28.96,140154,226272,366426,38.25,61.75,28.04
2010,"MI-02",125015,204490,329505,37.94,62.06,26.34,165867,242557,408424,40.61,59.39,23.32
2010,"MI-03",151268,175427,326695,46.3,53.7,9.62,204112,199704,403816,50.55,49.45,3.44000000000001
2010,"MI-04",121750,188494,310244,39.24,60.76,23.74,153663,222759,376422,40.82,59.18,22.9
2010,"MI-05",145485,130366,275851,52.74,47.26,-3.25999999999999,168362,152078,320440,52.54,47.46,-0.539999999999992
2010,"MI-06",136542,157832,294374,46.38,53.62,9.46000000000001,171950,182683,354633,48.49,51.51,7.56
2010,"MI-07",128889,172705,301594,42.74,57.26,16.74,160583,201760,362343,44.32,55.68,15.9
2010,"MI-08",161115,188967,350082,46.02,53.98,10.18,206827,217075,423902,48.79,51.21,6.96000000000001
2010,"MI-09",189747,153727,343474,55.24,44.76,-8.26000000000001,239560,169850,409410,58.51,41.49,-12.48
2010,"MI-10",117458,229771,347229,33.83,66.17,34.56,152479,275432,427911,35.63,64.37,33.28
2010,"MI-11",179086,173745,352831,50.76,49.24,0.699999999999996,235579,195767,431346,54.61,45.39,-4.67999999999999
2010,"MI-12",184133,118011,302144,60.94,39.06,-19.66,221471,135671,357142,62.01,37.99,-19.48
2010,"MI-13",146867,33014,179881,81.65,18.35,-61.08,158101,38981,197082,80.22,19.78,-55.9
2010,"MI-14",176826,38520,215346,82.11,17.89,-62,191265,46334,237599,80.5,19.5,-56.46
2010,"MI-15",192946,121170,314116,61.43,38.57,-20.64,234023,142892,376915,62.09,37.91,-19.64
2012,"MI-01",133379,211049,344428,38.72,61.28,24.78,171565,244686,416251,41.22,58.78,22.1
2012,"MI-02",132529,193310,325839,40.67,59.33,20.88,177176,225520,402696,44,56,16.54
2012,"MI-03",147476,180509,327985,44.96,55.04,12.3,194721,207962,402683,48.36,51.64,7.82000000000001
2012,"MI-04",113667,195096,308763,36.81,63.19,28.6,143043,234537,377580,37.88,62.12,28.78
2012,"MI-05",162859,148784,311643,52.26,47.74,-2.3,189118,172965,362083,52.23,47.77,0.0800000000000125
2012,"MI-06",142100,170017,312117,45.53,54.47,11.16,179862,197207,377069,47.7,52.3,9.14000000000001
2012,"MI-07",131681,189691,321372,40.97,59.03,20.28,164987,224500,389487,42.36,57.64,19.82
2012,"MI-08",164487,189955,354442,46.41,53.59,9.4,211632,215451,427083,49.55,50.45,5.44
2012,"MI-09",183110,155633,338743,54.06,45.94,-5.9,229568,175318,404886,56.7,43.3,-8.85999999999999
2012,"MI-10",113101,228271,341372,33.13,66.87,35.96,146819,273838,420657,34.9,65.1,34.74
2012,"MI-11",177120,194222,371342,47.7,52.3,6.82000000000001,237726,216815,454541,52.3,47.7,-0.0600000000000023
2012,"MI-12",205826,116706,322532,63.82,36.18,-25.42,251649,134865,386514,65.11,34.89,-25.68
2012,"MI-13",209143,48110,257253,81.3,18.7,-60.38,229543,58149,287692,79.79,20.21,-55.04
2012,"MI-14",252361,58190,310551,81.26,18.74,-60.3,276586,68004,344590,80.27,19.73,-56
2014,"MI-01",133379,211049,344428,38.72,61.28,24.78,171565,244686,416251,41.22,58.78,22.1
2014,"MI-02",132529,193310,325839,40.67,59.33,20.88,177176,225520,402696,44,56,16.54
2014,"MI-03",147476,180509,327985,44.96,55.04,12.3,194721,207962,402683,48.36,51.64,7.82000000000001
2014,"MI-04",113667,195096,308763,36.81,63.19,28.6,143043,234537,377580,37.88,62.12,28.78
2014,"MI-05",162859,148784,311643,52.26,47.74,-2.3,189118,172965,362083,52.23,47.77,0.0800000000000125
2014,"MI-06",142100,170017,312117,45.53,54.47,11.16,179862,197207,377069,47.7,52.3,9.14000000000001
2014,"MI-07",131681,189691,321372,40.97,59.03,20.28,164987,224500,389487,42.36,57.64,19.82
2014,"MI-08",164487,189955,354442,46.41,53.59,9.4,211632,215451,427083,49.55,50.45,5.44
2014,"MI-09",183110,155633,338743,54.06,45.94,-5.9,229568,175318,404886,56.7,43.3,-8.85999999999999
2014,"MI-10",113101,228271,341372,33.13,66.87,35.96,146819,273838,420657,34.9,65.1,34.74
2014,"MI-11",177120,194222,371342,47.7,52.3,6.82000000000001,237726,216815,454541,52.3,47.7,-0.0600000000000023
2014,"MI-12",205831,116707,322538,63.82,36.18,-25.42,251649,134865,386514,65.11,34.89,-25.68
2014,"MI-13",209138,48109,257247,81.3,18.7,-60.38,229543,58149,287692,79.79,20.21,-55.04
2014,"MI-14",252361,58190,310551,81.26,18.74,-60.3,276586,68004,344590,80.27,19.73,-56
2016,"MI-01",133379,211049,344428,38.72,61.28,24.78,171565,244686,416251,41.22,58.78,22.1
2016,"MI-02",132528,193307,325835,40.67,59.33,20.88,177161,225515,402676,44,56,16.54
2016,"MI-03",147477,180512,327989,44.96,55.04,12.3,194736,207967,402703,48.36,51.64,7.82000000000001
2016,"MI-04",113667,195096,308763,36.81,63.19,28.6,143043,234537,377580,37.88,62.12,28.78
2016,"MI-05",162859,148784,311643,52.26,47.74,-2.3,189118,172965,362083,52.23,47.77,0.0800000000000125
2016,"MI-06",142100,170017,312117,45.53,54.47,11.16,179862,197207,377069,47.7,52.3,9.14000000000001
2016,"MI-07",131681,189691,321372,40.97,59.03,20.28,164987,224500,389487,42.36,57.64,19.82
2016,"MI-08",164487,189955,354442,46.41,53.59,9.4,211632,215451,427083,49.55,50.45,5.44
2016,"MI-09",183110,155633,338743,54.06,45.94,-5.9,229568,175318,404886,56.7,43.3,-8.85999999999999
2016,"MI-10",113101,228271,341372,33.13,66.87,35.96,146819,273838,420657,34.9,65.1,34.74
2016,"MI-11",177120,194222,371342,47.7,52.3,6.82000000000001,237726,216815,454541,52.3,47.7,-0.0600000000000023
2016,"MI-12",205831,116707,322538,63.82,36.18,-25.42,251649,134865,386514,65.11,34.89,-25.68
2016,"MI-13",209138,48109,257247,81.3,18.7,-60.38,229543,58149,287692,79.79,20.21,-55.04
2016,"MI-14",252361,58190,310551,81.26,18.74,-60.3,276586,68004,344590,80.27,19.73,-56
2018,"MI-01",133379,211049,344428,38.72,61.28,24.78,171565,244686,416251,41.22,58.78,22.1
2018,"MI-02",132564,193323,325887,40.68,59.32,20.86,177144,225513,402657,43.99,56.01,16.56
2018,"MI-03",147442,180496,327938,44.96,55.04,12.3,194758,207975,402733,48.36,51.64,7.82000000000001
2018,"MI-04",113663,195091,308754,36.81,63.19,28.6,143038,234530,377568,37.88,62.12,28.78
2018,"MI-05",162859,148784,311643,52.26,47.74,-2.3,189118,172965,362083,52.23,47.77,0.0800000000000125
2018,"MI-06",142103,170022,312125,45.53,54.47,11.16,179862,197207,377069,47.7,52.3,9.14000000000001
2018,"MI-07",131643,189658,321301,40.97,59.03,20.28,164952,224461,389413,42.36,57.64,19.82
2018,"MI-08",164477,189936,354413,46.41,53.59,9.4,211626,215437,427063,49.55,50.45,5.44
2018,"MI-09",183215,155668,338883,54.06,45.94,-5.9,229623,175362,404985,56.7,43.3,-8.85999999999999
2018,"MI-10",113106,228284,341390,33.13,66.87,35.96,146808,273838,420646,34.9,65.1,34.74
2018,"MI-11",177107,194204,371311,47.7,52.3,6.82000000000001,237713,216808,454521,52.3,47.7,-0.0600000000000023
2018,"MI-12",205804,116703,322507,63.81,36.19,-25.4,251640,134895,386535,65.1,34.9,-25.66
2018,"MI-13",209195,48146,257341,81.29,18.71,-60.36,229558,58153,287711,79.79,20.21,-55.04
2018,"MI-14",252282,58179,310461,81.26,18.74,-60.3,276598,67995,344593,80.27,19.73,-56
2020,"MI-01",133379,211049,344428,38.72,61.28,24.78,171565,244686,416251,41.22,58.78,22.1
2020,"MI-02",132564,193323,325887,40.68,59.32,20.86,177144,225513,402657,43.99,56.01,16.56
2020,"MI-03",147442,180496,327938,44.96,55.04,12.3,194758,207975,402733,48.36,51.64,7.82000000000001
2020,"MI-04",113663,195091,308754,36.81,63.19,28.6,143038,234530,377568,37.88,62.12,28.78
2020,"MI-05",162859,148784,311643,52.26,47.74,-2.3,189118,172965,362083,52.23,47.77,0.0800000000000125
2020,"MI-06",142103,170022,312125,45.53,54.47,11.16,179862,197207,377069,47.7,52.3,9.14000000000001
2020,"MI-07",131720,189695,321415,40.98,59.02,20.26,165028,224502,389530,42.37,57.63,19.8
2020,"MI-08",164477,189936,354413,46.41,53.59,9.4,211626,215437,427063,49.55,50.45,5.44
2020,"MI-09",183215,155659,338874,54.07,45.93,-5.91999999999999,229644,175359,405003,56.7,43.3,-8.85999999999999
2020,"MI-10",113111,228290,341401,33.13,66.87,35.96,146813,273846,420659,34.9,65.1,34.74
2020,"MI-11",177115,194210,371325,47.7,52.3,6.82000000000001,237713,216808,454521,52.3,47.7,-0.0600000000000023
2020,"MI-12",205727,116666,322393,63.81,36.19,-25.4,251557,134853,386410,65.1,34.9,-25.66
2020,"MI-13",209200,48146,257346,81.29,18.71,-60.36,229585,58157,287742,79.79,20.21,-55.04
2020,"MI-14",252264,58176,310440,81.26,18.74,-60.3,276552,67987,344539,80.27,19.73,-56
2022,"MI-01",142930,236292,379222,37.69,62.31,26.84,182909,274830,457739,39.96,60.04,24.62
2022,"MI-02",114168,211751,325919,35.03,64.97,32.16,144792,261849,406641,35.61,64.39,33.32
2022,"MI-03",167229,166707,333936,50.08,49.92,2.05999999999999,222612,187243,409855,54.31,45.69,-4.08
2022,"MI-04",152462,186560,339022,44.97,55.03,12.28,196663,213090,409753,48,52,8.54000000000001
2022,"MI-05",120338,208570,328908,36.59,63.41,29.04,150400,248474,398874,37.71,62.29,29.12
2022,"MI-06",227098,145574,372672,60.94,39.06,-19.66,286036,164311,450347,63.51,36.49,-22.48
2022,"MI-07",174959,189770,364729,47.97,52.03,6.28,222422,218322,440744,50.47,49.53,3.6
2022,"MI-08",183128,179004,362132,50.57,49.43,1.07999999999999,215553,206742,422295,51.04,48.96,2.46000000000001
2022,"MI-09",120616,249333,369949,32.6,67.4,37.02,160174,296889,457063,35.04,64.96,34.46
2022,"MI-10",166897,186853,353750,47.18,52.82,7.86,210167,214236,424403,49.52,50.48,5.50000000000001
2022,"MI-11",218348,162827,381175,57.28,42.72,-12.34,274137,182453,456590,60.04,39.96,-15.54
2022,"MI-12",250134,85681,335815,74.49,25.51,-46.76,285404,97496,382900,74.54,25.46,-44.54
2022,"MI-13",230532,70620,301152,76.55,23.45,-50.88,252734,83890,336624,75.08,24.92,-45.62
2008,"MN-01",127732,177471,305203,41.85,58.15,18.52,159676,196897,356573,44.78,55.22,14.98
2008,"MN-02",181423,206466,387889,46.77,53.23,8.67999999999999,244345,234161,478506,51.06,48.94,2.42
2008,"MN-03",200960,153285,354245,56.73,43.27,-11.24,261497,165242,426739,61.28,38.72,-18.02
2008,"MN-04",208292,93220,301512,69.08,30.92,-35.94,249782,101885,351667,71.03,28.97,-37.52
2008,"MN-05",258416,62307,320723,80.57,19.43,-58.92,310324,65576,375900,82.55,17.45,-60.56
2008,"MN-06",152685,241700,394385,38.71,61.29,24.8,203781,276269,480050,42.45,57.55,19.64
2008,"MN-07",99970,194738,294708,33.92,66.08,34.38,121242,219900,341142,35.54,64.46,33.46
2008,"MN-08",138161,193687,331848,41.63,58.37,18.96,166330,224046,390376,42.61,57.39,19.32
2010,"MN-01",127732,177471,305203,41.85,58.15,18.52,159676,196897,356573,44.78,55.22,14.98
2010,"MN-02",181423,206466,387889,46.77,53.23,8.67999999999999,244345,234161,478506,51.06,48.94,2.42
2010,"MN-03",200960,153285,354245,56.73,43.27,-11.24,261497,165242,426739,61.28,38.72,-18.02
2010,"MN-04",208292,93220,301512,69.08,30.92,-35.94,249782,101885,351667,71.03,28.97,-37.52
2010,"MN-05",258416,62307,320723,80.57,19.43,-58.92,310324,65576,375900,82.55,17.45,-60.56
2010,"MN-06",152685,241700,394385,38.71,61.29,24.8,203781,276269,480050,42.45,57.55,19.64
2010,"MN-07",99970,194738,294708,33.92,66.08,34.38,121242,219900,341142,35.54,64.46,33.46
2010,"MN-08",138161,193687,331848,41.63,58.37,18.96,166330,224046,390376,42.61,57.39,19.32
2012,"MN-01",130829,181648,312477,41.87,58.13,18.48,164133,202123,366256,44.81,55.19,14.92
2012,"MN-02",171230,175766,346996,49.35,50.65,3.51999999999999,226478,196946,423424,53.49,46.51,-2.44
2012,"MN-03",201850,164333,366183,55.12,44.88,-8.02000000000001,265861,178653,444514,59.81,40.19,-15.08
2012,"MN-04",223944,111207,335151,66.82,33.18,-31.42,273404,123354,396758,68.91,31.09,-33.28
2012,"MN-05",273348,68552,341900,79.95,20.05,-57.68,328746,72358,401104,81.96,18.04,-59.38
2012,"MN-06",123239,218390,341629,36.07,63.93,30.08,164926,250513,415439,39.7,60.3,25.14
2012,"MN-07",104557,208226,312783,33.43,66.57,35.36,126520,234767,361287,35.02,64.98,34.5
2012,"MN-08",138656,194762,333418,41.59,58.41,19.04,166925,225268,392193,42.56,57.44,19.42
2014,"MN-01",130829,181648,312477,41.87,58.13,18.48,164133,202123,366256,44.81,55.19,14.92
2014,"MN-02",171230,175766,346996,49.35,50.65,3.51999999999999,226478,196946,423424,53.49,46.51,-2.44
2014,"MN-03",201810,164276,366086,55.13,44.87,-8.04000000000001,265799,178583,444382,59.81,40.19,-15.08
2014,"MN-04",223944,111207,335151,66.82,33.18,-31.42,273404,123354,396758,68.91,31.09,-33.28
2014,"MN-05",273336,68547,341883,79.95,20.05,-57.68,328730,72352,401082,81.96,18.04,-59.38
2014,"MN-06",123281,218452,341733,36.08,63.92,30.06,164991,250589,415580,39.7,60.3,25.14
2014,"MN-07",104555,208221,312776,33.43,66.57,35.36,126517,234761,361278,35.02,64.98,34.5
2014,"MN-08",138656,194762,333418,41.59,58.41,19.04,166925,225268,392193,42.56,57.44,19.42
2016,"MN-01",130829,181648,312477,41.87,58.13,18.48,164133,202123,366256,44.81,55.19,14.92
2016,"MN-02",171246,175780,347026,49.35,50.65,3.51999999999999,226491,196956,423447,53.49,46.51,-2.44
2016,"MN-03",201876,164345,366221,55.12,44.88,-8.02000000000001,265907,178664,444571,59.81,40.19,-15.08
2016,"MN-04",223928,111193,335121,66.82,33.18,-31.42,273391,123344,396735,68.91,31.09,-33.28
2016,"MN-05",273309,68525,341834,79.95,20.05,-57.68,328679,72326,401005,81.96,18.04,-59.38
2016,"MN-06",123246,218416,341662,36.07,63.93,30.08,164938,250546,415484,39.7,60.3,25.14
2016,"MN-07",104526,208186,312712,33.43,66.57,35.36,126480,234724,361204,35.02,64.98,34.5
2016,"MN-08",138681,194786,333467,41.59,58.41,19.04,166958,225293,392251,42.56,57.44,19.42
2018,"MN-01",130824,181639,312463,41.87,58.13,18.48,164124,202111,366235,44.81,55.19,14.92
2018,"MN-02",171249,175782,347031,49.35,50.65,3.51999999999999,226494,196958,423452,53.49,46.51,-2.44
2018,"MN-03",201846,164300,366146,55.13,44.87,-8.04000000000001,265861,178611,444472,59.82,40.18,-15.1
2018,"MN-04",223925,111191,335116,66.82,33.18,-31.42,273388,123342,396730,68.91,31.09,-33.28
2018,"MN-05",273313,68532,341845,79.95,20.05,-57.68,328684,72332,401016,81.96,18.04,-59.38
2018,"MN-06",123280,218460,341740,36.07,63.93,30.08,164986,250595,415581,39.7,60.3,25.14
2018,"MN-07",104549,208216,312765,33.43,66.57,35.36,126513,234763,361276,35.02,64.98,34.5
2018,"MN-08",138681,194786,333467,41.59,58.41,19.04,166958,225293,392251,42.56,57.44,19.42
2020,"MN-01",130824,181639,312463,41.87,58.13,18.48,164124,202111,366235,44.81,55.19,14.92
2020,"MN-02",171255,175775,347030,49.35,50.65,3.51999999999999,226486,196937,423423,53.49,46.51,-2.44
2020,"MN-03",201836,164307,366143,55.12,44.88,-8.02000000000001,265850,178620,444470,59.81,40.19,-15.08
2020,"MN-04",223808,111162,334970,66.81,33.19,-31.4,273267,123329,396596,68.9,31.1,-33.26
2020,"MN-05",273432,68566,341998,79.95,20.05,-57.68,328824,72363,401187,81.96,18.04,-59.38
2020,"MN-06",123278,218449,341727,36.07,63.93,30.08,164984,250589,415573,39.7,60.3,25.14
2020,"MN-07",104549,208216,312765,33.43,66.57,35.36,126509,234756,361265,35.02,64.98,34.5
2020,"MN-08",138690,194804,333494,41.59,58.41,19.04,166969,225316,392285,42.56,57.44,19.42
2022,"MN-01",137487,186964,324451,42.38,57.62,17.46,172262,208039,380301,45.3,54.7,13.94
2022,"MN-02",166972,170785,337757,49.44,50.56,3.34,222755,192181,414936,53.68,46.32,-2.82
2022,"MN-03",197878,155320,353198,56.02,43.98,-9.82,258660,167589,426249,60.68,39.32,-16.82
2022,"MN-04",220035,107353,327388,67.21,32.79,-32.2,267160,118296,385456,69.31,30.69,-34.08
2022,"MN-05",266252,65611,331863,80.23,19.77,-58.24,319458,69167,388625,82.2,17.8,-59.86
2022,"MN-06",122079,207488,329567,37.04,62.96,28.14,165561,238376,403937,40.99,59.01,22.56
2022,"MN-07",106634,230524,337158,31.63,68.37,38.96,128660,260275,388935,33.08,66.92,38.38
2022,"MN-08",150332,198867,349199,43.05,56.95,16.12,182498,230098,412596,44.23,55.77,16.08
2008,"MS-01",110789,214258,325047,34.08,65.92,34.06,126232,234183,360415,35.02,64.98,34.5
2008,"MS-02",170283,88166,258449,65.89,34.11,-29.56,176692,92034,268726,65.75,34.25,-26.96
2008,"MS-03",120813,198837,319650,37.8,62.2,26.62,136324,209541,345865,39.42,60.58,25.7
2008,"MS-04",83127,199382,282509,29.42,70.58,43.38,100024,220929,320953,31.16,68.84,42.22
2010,"MS-01",110789,214258,325047,34.08,65.92,34.06,126232,234183,360415,35.02,64.98,34.5
2010,"MS-02",170283,88166,258449,65.89,34.11,-29.56,176692,92034,268726,65.75,34.25,-26.96
2010,"MS-03",120813,198837,319650,37.8,62.2,26.62,136324,209541,345865,39.42,60.58,25.7
2010,"MS-04",83127,199382,282509,29.42,70.58,43.38,100024,220929,320953,31.16,68.84,42.22
2012,"MS-01",100813,203211,304024,33.16,66.84,35.9,115925,222416,338341,34.26,65.74,36.02
2012,"MS-02",185402,102499,287901,64.4,35.6,-26.58,191540,105781,297321,64.42,35.58,-24.3
2012,"MS-03",118818,198318,317136,37.47,62.53,27.28,135150,210477,345627,39.1,60.9,26.34
2012,"MS-04",80047,196652,276699,28.93,71.07,44.36,96733,218056,314789,30.73,69.27,43.08
2014,"MS-01",100813,203211,304024,33.16,66.84,35.9,115925,222416,338341,34.26,65.74,36.02
2014,"MS-02",185402,102499,287901,64.4,35.6,-26.58,191540,105781,297321,64.42,35.58,-24.3
2014,"MS-03",118818,198318,317136,37.47,62.53,27.28,135150,210477,345627,39.1,60.9,26.34
2014,"MS-04",80047,196652,276699,28.93,71.07,44.36,96733,218056,314789,30.73,69.27,43.08
2016,"MS-01",100813,203211,304024,33.16,66.84,35.9,115925,222416,338341,34.26,65.74,36.02
2016,"MS-02",185402,102499,287901,64.4,35.6,-26.58,191540,105781,297321,64.42,35.58,-24.3
2016,"MS-03",118818,198318,317136,37.47,62.53,27.28,135150,210477,345627,39.1,60.9,26.34
2016,"MS-04",80047,196652,276699,28.93,71.07,44.36,96733,218056,314789,30.73,69.27,43.08
2018,"MS-01",100813,203211,304024,33.16,66.84,35.9,115925,222416,338341,34.26,65.74,36.02
2018,"MS-02",185402,102499,287901,64.4,35.6,-26.58,191540,105781,297321,64.42,35.58,-24.3
2018,"MS-03",118818,198318,317136,37.47,62.53,27.28,135150,210477,345627,39.1,60.9,26.34
2018,"MS-04",80047,196652,276699,28.93,71.07,44.36,96733,218056,314789,30.73,69.27,43.08
2020,"MS-01",100814,203214,304028,33.16,66.84,35.9,115927,222420,338347,34.26,65.74,36.02
2020,"MS-02",185453,102530,287983,64.4,35.6,-26.58,191590,105811,297401,64.42,35.58,-24.3
2020,"MS-03",118817,198318,317135,37.47,62.53,27.28,135148,210477,345625,39.1,60.9,26.34
2020,"MS-04",80047,196652,276699,28.93,71.07,44.36,96733,218056,314789,30.73,69.27,43.08
2022,"MS-01",96615,198297,294912,32.76,67.24,36.7,111536,217294,328830,33.92,66.08,36.7
2022,"MS-02",201771,117787,319558,63.14,36.86,-24.06,208202,121156,329358,63.21,36.79,-21.88
2022,"MS-03",111903,199701,311604,35.91,64.09,30.4,128389,212436,340825,37.67,62.33,29.2
2022,"MS-04",74842,184929,259771,28.81,71.19,44.6,91271,205878,297149,30.72,69.28,43.1
2008,"MO-01",192825,50456,243281,79.26,20.74,-56.3,197182,48471,245653,80.27,19.73,-56
2008,"MO-02",148355,227310,375665,39.49,60.51,23.24,190554,236773,427327,44.59,55.41,15.36
2008,"MO-03",148622,139565,288187,51.57,48.43,-0.920000000000009,174517,148001,322518,54.11,45.89,-3.67999999999999
2008,"MO-04",70263,217440,287703,24.42,75.58,53.38,80951,242360,323311,25.04,74.96,54.46
2008,"MO-05",161879,104040,265919,60.88,39.12,-19.54,188583,110369,298952,63.08,36.92,-21.62
2008,"MO-06",111550,200828,312378,35.71,64.29,30.8,141197,221159,362356,38.97,61.03,26.6
2008,"MO-07",81908,230105,312013,26.25,73.75,49.72,102990,251235,354225,29.07,70.93,46.4
2008,"MO-08",55604,211094,266698,20.85,79.15,60.52,59320,228095,287415,20.64,79.36,63.26
2008,"MO-09",99987,213655,313642,31.88,68.12,38.46,117635,232254,349889,33.62,66.38,37.3
2010,"MO-01",192825,50456,243281,79.26,20.74,-56.3,197182,48471,245653,80.27,19.73,-56
2010,"MO-02",148355,227310,375665,39.49,60.51,23.24,190554,236773,427327,44.59,55.41,15.36
2010,"MO-03",148622,139565,288187,51.57,48.43,-0.920000000000009,174517,148001,322518,54.11,45.89,-3.67999999999999
2010,"MO-04",70263,217440,287703,24.42,75.58,53.38,80951,242360,323311,25.04,74.96,54.46
2010,"MO-05",161879,104040,265919,60.88,39.12,-19.54,188583,110369,298952,63.08,36.92,-21.62
2010,"MO-06",111550,200828,312378,35.71,64.29,30.8,141197,221159,362356,38.97,61.03,26.6
2010,"MO-07",81908,230105,312013,26.25,73.75,49.72,102990,251235,354225,29.07,70.93,46.4
2010,"MO-08",55604,211094,266698,20.85,79.15,60.52,59320,228095,287415,20.64,79.36,63.26
2010,"MO-09",99987,213655,313642,31.88,68.12,38.46,117635,232254,349889,33.62,66.38,37.3
2012,"MO-01",246012,60102,306114,80.37,19.63,-58.52,257808,58261,316069,81.57,18.43,-58.6
2012,"MO-02",177507,220495,398002,44.6,55.4,13.02,221755,221121,442876,50.07,49.93,4.40000000000001
2012,"MO-03",106187,253683,359870,29.51,70.49,43.2,131279,279570,410849,31.95,68.05,40.64
2012,"MO-04",99988,222719,322707,30.98,69.02,40.26,118195,244474,362669,32.59,67.41,39.36
2012,"MO-05",179348,130091,309439,57.96,42.04,-13.7,210906,142281,353187,59.72,40.28,-14.9
2012,"MO-06",110491,226808,337299,32.76,67.24,36.7,135060,247819,382879,35.27,64.73,34
2012,"MO-07",84431,240751,325182,25.96,74.04,50.3,105866,263684,369550,28.65,71.35,47.24
2012,"MO-08",67023,239839,306862,21.84,78.16,58.54,72061,261506,333567,21.6,78.4,61.34
2014,"MO-01",246012,60102,306114,80.37,19.63,-58.52,257812,58262,316074,81.57,18.43,-58.6
2014,"MO-02",177507,220495,398002,44.6,55.4,13.02,221751,221120,442871,50.07,49.93,4.40000000000001
2014,"MO-03",106187,253683,359870,29.51,70.49,43.2,131279,279570,410849,31.95,68.05,40.64
2014,"MO-04",99988,222719,322707,30.98,69.02,40.26,118195,244474,362669,32.59,67.41,39.36
2014,"MO-05",179348,130091,309439,57.96,42.04,-13.7,210906,142281,353187,59.72,40.28,-14.9
2014,"MO-06",110491,226808,337299,32.76,67.24,36.7,135060,247819,382879,35.27,64.73,34
2014,"MO-07",84431,240751,325182,25.96,74.04,50.3,105866,263684,369550,28.65,71.35,47.24
2014,"MO-08",67023,239839,306862,21.84,78.16,58.54,72061,261506,333567,21.6,78.4,61.34
2016,"MO-01",245963,60078,306041,80.37,19.63,-58.52,257752,58237,315989,81.57,18.43,-58.6
2016,"MO-02",177573,220540,398113,44.6,55.4,13.02,221831,221164,442995,50.08,49.92,4.38
2016,"MO-03",106170,253662,359832,29.51,70.49,43.2,131259,279551,410810,31.95,68.05,40.64
2016,"MO-04",99976,222695,322671,30.98,69.02,40.26,118175,244444,362619,32.59,67.41,39.36
2016,"MO-05",179365,130120,309485,57.96,42.04,-13.7,210932,142316,353248,59.71,40.29,-14.88
2016,"MO-06",110486,226803,337289,32.76,67.24,36.7,135054,247814,382868,35.27,64.73,34
2016,"MO-07",84431,240751,325182,25.96,74.04,50.3,105866,263684,369550,28.65,71.35,47.24
2016,"MO-08",67023,239839,306862,21.84,78.16,58.54,72061,261506,333567,21.6,78.4,61.34
2018,"MO-01",245965,60078,306043,80.37,19.63,-58.52,257752,58236,315988,81.57,18.43,-58.6
2018,"MO-02",177571,220540,398111,44.6,55.4,13.02,221831,221165,442996,50.08,49.92,4.38
2018,"MO-03",106170,253662,359832,29.51,70.49,43.2,131259,279551,410810,31.95,68.05,40.64
2018,"MO-04",99976,222695,322671,30.98,69.02,40.26,118175,244444,362619,32.59,67.41,39.36
2018,"MO-05",179370,130124,309494,57.96,42.04,-13.7,210940,142321,353261,59.71,40.29,-14.88
2018,"MO-06",110481,226799,337280,32.76,67.24,36.7,135046,247809,382855,35.27,64.73,34
2018,"MO-07",84431,240751,325182,25.96,74.04,50.3,105866,263684,369550,28.65,71.35,47.24
2018,"MO-08",67023,239839,306862,21.84,78.16,58.54,72061,261506,333567,21.6,78.4,61.34
2020,"MO-01",246071,60105,306176,80.37,19.63,-58.52,257850,58258,316108,81.57,18.43,-58.6
2020,"MO-02",177550,220549,398099,44.6,55.4,13.02,221821,221173,442994,50.07,49.93,4.40000000000001
2020,"MO-03",106166,253648,359814,29.51,70.49,43.2,131255,279541,410796,31.95,68.05,40.64
2020,"MO-04",99979,222710,322689,30.98,69.02,40.26,118178,244460,362638,32.59,67.41,39.36
2020,"MO-05",179370,130124,309494,57.96,42.04,-13.7,210940,142321,353261,59.71,40.29,-14.88
2020,"MO-06",110481,226799,337280,32.76,67.24,36.7,135046,247809,382855,35.27,64.73,34
2020,"MO-07",84428,240736,325164,25.96,74.04,50.3,105863,263668,369531,28.65,71.35,47.24
2020,"MO-08",67023,239839,306862,21.84,78.16,58.54,72061,261506,333567,21.6,78.4,61.34
2022,"MO-01",262172,72719,334891,78.29,21.71,-54.36,277704,70640,348344,79.72,20.28,-54.9
2022,"MO-02",159554,226347,385901,41.35,58.65,19.52,199279,233160,432439,46.08,53.92,12.38
2022,"MO-03",117478,230270,347748,33.78,66.22,34.66,143063,246710,389773,36.7,63.3,31.14
2022,"MO-04",89563,230155,319718,28.01,71.99,46.2,109249,257417,366666,29.8,70.2,44.94
2022,"MO-05",183799,118418,302217,60.82,39.18,-19.42,217636,125328,342964,63.46,36.54,-22.38
2022,"MO-06",98453,231690,330143,29.82,70.18,42.58,115983,256341,372324,31.15,68.85,42.24
2022,"MO-07",82220,232449,314669,26.13,73.87,49.96,103463,254367,357830,28.91,71.09,46.72
2022,"MO-08",77829,252462,330291,23.56,76.44,55.1,86637,274774,361411,23.97,76.03,56.6
2008,"MT-01",177706,279236,456942,38.89,61.11,24.44,244781,343597,588378,41.6,58.4,21.34
2010,"MT-01",177706,279236,456942,38.89,61.11,24.44,244781,343597,588378,41.6,58.4,21.34
2012,"MT-01",177706,279236,456942,38.89,61.11,24.44,244781,343597,588378,41.6,58.4,21.34
2014,"MT-01",177706,279236,456942,38.89,61.11,24.44,244781,343597,588378,41.6,58.4,21.34
2016,"MT-01",177709,279240,456949,38.89,61.11,24.44,244786,343602,588388,41.6,58.4,21.34
2018,"MT-01",177709,279240,456949,38.89,61.11,24.44,244786,343602,588388,41.6,58.4,21.34
2020,"MT-01",177709,279240,456949,38.89,61.11,24.44,244786,343602,588388,41.6,58.4,21.34
2022,"MT-01",101343,131094,232437,43.6,56.4,15.02,143418,165195,308613,46.47,53.53,11.6
2022,"MT-02",76366,148146,224512,34.01,65.99,34.2,101368,178407,279775,36.23,63.77,32.08
2008,"NE-01",103243,167635,270878,38.11,61.89,26,136697,193840,330537,41.36,58.64,21.82
2008,"NE-02",134077,138625,272702,49.17,50.83,3.88,179170,152551,331721,54.01,45.99,-3.48
2008,"NE-03",47169,189698,236867,19.91,80.09,62.4,58711,210452,269163,21.81,78.19,60.92
2010,"NE-01",103243,167635,270878,38.11,61.89,26,136697,193840,330537,41.36,58.64,21.82
2010,"NE-02",134077,138625,272702,49.17,50.83,3.88,179170,152551,331721,54.01,45.99,-3.48
2010,"NE-03",47169,189698,236867,19.91,80.09,62.4,58711,210452,269163,21.81,78.19,60.92
2012,"NE-01",99919,158428,258347,38.68,61.32,24.86,132048,180178,312226,42.29,57.71,19.96
2012,"NE-02",131191,137664,268855,48.8,51.2,4.62,176649,154430,331079,53.36,46.64,-2.17999999999999
2012,"NE-03",53379,199866,253245,21.08,78.92,60.06,65880,222235,288115,22.87,77.13,58.8
2014,"NE-01",99919,158428,258347,38.68,61.32,24.86,132048,180178,312226,42.29,57.71,19.96
2014,"NE-02",131191,137664,268855,48.8,51.2,4.62,176649,154430,331079,53.36,46.64,-2.17999999999999
2014,"NE-03",53379,199866,253245,21.08,78.92,60.06,65880,222235,288115,22.87,77.13,58.8
2016,"NE-01",99919,158428,258347,38.68,61.32,24.86,132048,180178,312226,42.29,57.71,19.96
2016,"NE-02",131191,137664,268855,48.8,51.2,4.62,176649,154430,331079,53.36,46.64,-2.17999999999999
2016,"NE-03",53379,199866,253245,21.08,78.92,60.06,65880,222235,288115,22.87,77.13,58.8
2018,"NE-01",99919,158428,258347,38.68,61.32,24.86,132048,180178,312226,42.29,57.71,19.96
2018,"NE-02",131191,137664,268855,48.8,51.2,4.62,176649,154430,331079,53.36,46.64,-2.17999999999999
2018,"NE-03",53379,199866,253245,21.08,78.92,60.06,65880,222235,288115,22.87,77.13,58.8
2020,"NE-01",99919,158428,258347,38.68,61.32,24.86,132048,180178,312226,42.29,57.71,19.96
2020,"NE-02",131191,137664,268855,48.8,51.2,4.62,176649,154430,331079,53.36,46.64,-2.17999999999999
2020,"NE-03",53379,199866,253245,21.08,78.92,60.06,65880,222235,288115,22.87,77.13,58.8
2022,"NE-01",101689,150915,252604,40.26,59.74,21.7,136400,170858,307258,44.39,55.61,15.76
2022,"NE-02",122596,127878,250474,48.95,51.05,4.32,163666,144027,307693,53.19,46.81,-1.84
2022,"NE-03",60204,217165,277369,21.71,78.29,58.8,74511,241958,316469,23.54,76.46,57.46
2008,"NV-01",162531,99542,262073,62.02,37.98,-21.82,197273,129790,327063,60.32,39.68,-16.1
2008,"NV-02",155109,211297,366406,42.33,57.67,17.56,207482,266359,473841,43.79,56.21,16.96
2008,"NV-03",221616,201213,422829,52.41,47.59,-2.60000000000001,298725,273734,572459,52.18,47.82,0.18
2010,"NV-01",162531,99542,262073,62.02,37.98,-21.82,197273,129790,327063,60.32,39.68,-16.1
2010,"NV-02",155109,211297,366406,42.33,57.67,17.56,207482,266359,473841,43.79,56.21,16.96
2010,"NV-03",221616,201213,422829,52.41,47.59,-2.60000000000001,298725,273734,572459,52.18,47.82,0.18
2012,"NV-01",121325,64226,185551,65.39,34.61,-28.56,143433,84960,228393,62.8,37.2,-21.06
2012,"NV-02",129318,169631,298949,43.26,56.74,15.7,171024,210254,381278,44.86,55.14,14.82
2012,"NV-03",151539,154807,306346,49.47,50.53,3.27999999999999,214156,213273,427429,50.1,49.9,4.34
2012,"NV-04",137077,123394,260471,52.63,47.37,-3.03999999999999,174873,161403,336276,52,48,0.540000000000006
2014,"NV-01",121325,64226,185551,65.39,34.61,-28.56,143433,84960,228393,62.8,37.2,-21.06
2014,"NV-02",129318,169631,298949,43.26,56.74,15.7,171024,210254,381278,44.86,55.14,14.82
2014,"NV-03",151539,154807,306346,49.47,50.53,3.27999999999999,214156,213273,427429,50.1,49.9,4.34
2014,"NV-04",137077,123394,260471,52.63,47.37,-3.03999999999999,174873,161403,336276,52,48,0.540000000000006
2016,"NV-01",121323,64225,185548,65.39,34.61,-28.56,143430,84958,228388,62.8,37.2,-21.06
2016,"NV-02",129318,169631,298949,43.26,56.74,15.7,171024,210254,381278,44.86,55.14,14.82
2016,"NV-03",151556,154828,306384,49.47,50.53,3.27999999999999,214194,213319,427513,50.1,49.9,4.34
2016,"NV-04",137062,123374,260436,52.63,47.37,-3.03999999999999,174838,161359,336197,52,48,0.540000000000006
2018,"NV-01",121323,64225,185548,65.39,34.61,-28.56,143430,84958,228388,62.8,37.2,-21.06
2018,"NV-02",129318,169631,298949,43.26,56.74,15.7,171024,210254,381278,44.86,55.14,14.82
2018,"NV-03",151556,154828,306384,49.47,50.53,3.27999999999999,214194,213319,427513,50.1,49.9,4.34
2018,"NV-04",137062,123374,260436,52.63,47.37,-3.03999999999999,174838,161359,336197,52,48,0.540000000000006
2020,"NV-01",121323,64225,185548,65.39,34.61,-28.56,143430,84958,228388,62.8,37.2,-21.06
2020,"NV-02",129318,169631,298949,43.26,56.74,15.7,171024,210254,381278,44.86,55.14,14.82
2020,"NV-03",151556,154828,306384,49.47,50.53,3.27999999999999,214194,213319,427513,50.1,49.9,4.34
2020,"NV-04",137062,123374,260436,52.63,47.37,-3.03999999999999,174838,161359,336197,52,48,0.540000000000006
2022,"NV-01",136835,110436,247271,55.34,44.66,-8.46000000000001,172443,144975,317418,54.33,45.67,-4.11999999999999
2022,"NV-02",130761,174835,305596,42.79,57.21,16.64,172869,216742,389611,44.37,55.63,15.8
2022,"NV-03",139125,120603,259728,53.57,46.43,-4.91999999999999,190027,166026,356053,53.37,46.63,-2.19999999999999
2022,"NV-04",132539,106183,238722,55.52,44.48,-8.82000000000001,168149,142146,310295,54.19,45.81,-3.84
2008,"NH-01",173415,179730,353145,49.11,50.89,4,213817,189532,403349,53.01,46.99,-1.48
2008,"NH-02",175060,165999,341059,51.33,48.67,-0.439999999999998,211057,176066,387123,54.52,45.48,-4.5
2010,"NH-01",173415,179730,353145,49.11,50.89,4,213817,189532,403349,53.01,46.99,-1.48
2010,"NH-02",175060,165999,341059,51.33,48.67,-0.439999999999998,211057,176066,387123,54.52,45.48,-4.5
2012,"NH-01",173387,179291,352678,49.16,50.84,3.9,213713,189033,402746,53.06,46.94,-1.57999999999999
2012,"NH-02",175088,166438,341526,51.27,48.73,-0.32,211161,176565,387726,54.46,45.54,-4.37999999999998
2014,"NH-01",173387,179291,352678,49.16,50.84,3.9,213713,189033,402746,53.06,46.94,-1.57999999999999
2014,"NH-02",175088,166438,341526,51.27,48.73,-0.32,211161,176565,387726,54.46,45.54,-4.37999999999998
2016,"NH-01",173344,179259,352603,49.16,50.84,3.9,213662,188999,402661,53.06,46.94,-1.57999999999999
2016,"NH-02",175182,166531,341713,51.27,48.73,-0.32,211275,176661,387936,54.46,45.54,-4.37999999999998
2018,"NH-01",173344,179259,352603,49.16,50.84,3.9,213662,188999,402661,53.06,46.94,-1.57999999999999
2018,"NH-02",175182,166531,341713,51.27,48.73,-0.32,211275,176661,387936,54.46,45.54,-4.37999999999998
2020,"NH-01",173344,179259,352603,49.16,50.84,3.9,213662,188999,402661,53.06,46.94,-1.57999999999999
2020,"NH-02",175182,166531,341713,51.27,48.73,-0.32,211275,176661,387936,54.46,45.54,-4.37999999999998
2022,"NH-01",168971,175571,344542,49.04,50.96,4.14000000000001,208130,185036,393166,52.94,47.06,-1.33999999999999
2022,"NH-02",177819,168892,346711,51.29,48.71,-0.359999999999999,214627,179250,393877,54.49,45.51,-4.44
2008,"NJ-01",177273,108399,285672,62.05,37.95,-21.88,214762,130680,345442,62.17,37.83,-19.8
2008,"NJ-02",140225,148528,288753,48.56,51.44,5.1,172829,178178,351007,49.24,50.76,6.06000000000001
2008,"NJ-03",160798,170947,331745,48.47,51.53,5.28,209814,199273,409087,51.29,48.71,1.96000000000001
2008,"NJ-04",137557,183142,320699,42.89,57.11,16.44,177807,219249,397056,44.78,55.22,14.98
2008,"NJ-05",147778,176912,324690,45.51,54.49,11.2,197646,199421,397067,49.78,50.22,4.98
2008,"NJ-06",153428,106777,260205,58.96,41.04,-15.7,184030,122892,306922,59.96,40.04,-15.38
2008,"NJ-07",169244,147399,316643,53.45,46.55,-4.67999999999999,217170,164082,381252,56.96,43.04,-9.38
2008,"NJ-08",177885,87290,265175,67.08,32.92,-31.94,202408,107626,310034,65.29,34.71,-26.04
2008,"NJ-09",162812,95276,258088,63.08,36.92,-23.94,190378,117407,307785,61.85,38.15,-19.16
2008,"NJ-10",199776,25560,225336,88.66,11.34,-75.1,212463,35359,247822,85.73,14.27,-66.92
2008,"NJ-11",158878,172163,331041,47.99,52.01,6.23999999999999,212374,192068,404442,52.51,47.49,-0.47999999999999
2008,"NJ-12",195456,134437,329893,59.25,40.75,-16.28,240282,154144,394426,60.92,39.08,-17.3
2008,"NJ-13",166694,44877,211571,78.79,21.21,-55.36,175834,62630,238464,73.74,26.26,-42.94
2010,"NJ-01",177273,108399,285672,62.05,37.95,-21.88,214762,130680,345442,62.17,37.83,-19.8
2010,"NJ-02",140225,148528,288753,48.56,51.44,5.1,172829,178178,351007,49.24,50.76,6.06000000000001
2010,"NJ-03",160798,170947,331745,48.47,51.53,5.28,209814,199273,409087,51.29,48.71,1.96000000000001
2010,"NJ-04",137557,183142,320699,42.89,57.11,16.44,177807,219249,397056,44.78,55.22,14.98
2010,"NJ-05",147778,176912,324690,45.51,54.49,11.2,197646,199421,397067,49.78,50.22,4.98
2010,"NJ-06",153428,106777,260205,58.96,41.04,-15.7,184030,122892,306922,59.96,40.04,-15.38
2010,"NJ-07",169244,147399,316643,53.45,46.55,-4.67999999999999,217170,164082,381252,56.96,43.04,-9.38
2010,"NJ-08",177885,87290,265175,67.08,32.92,-31.94,202408,107626,310034,65.29,34.71,-26.04
2010,"NJ-09",162812,95276,258088,63.08,36.92,-23.94,190378,117407,307785,61.85,38.15,-19.16
2010,"NJ-10",199776,25560,225336,88.66,11.34,-75.1,212463,35359,247822,85.73,14.27,-66.92
2010,"NJ-11",158878,172163,331041,47.99,52.01,6.23999999999999,212374,192068,404442,52.51,47.49,-0.47999999999999
2010,"NJ-12",195456,134437,329893,59.25,40.75,-16.28,240282,154144,394426,60.92,39.08,-17.3
2010,"NJ-13",166694,44877,211571,78.79,21.21,-55.36,175834,62630,238464,73.74,26.26,-42.94
2012,"NJ-01",199095,118771,317866,62.63,37.37,-23.04,241889,142686,384575,62.9,37.1,-21.26
2012,"NJ-02",147536,162279,309815,47.62,52.38,6.98,183079,194136,377215,48.53,51.47,7.48000000000001
2012,"NJ-03",165200,187865,353065,46.79,53.21,8.64,217341,218266,435607,49.89,50.11,4.76000000000001
2012,"NJ-04",146253,198915,345168,42.37,57.63,17.48,191376,236900,428276,44.69,55.31,15.16
2012,"NJ-05",174049,178112,352161,49.42,50.58,3.38000000000001,224997,202447,427444,52.64,47.36,-0.739999999999995
2012,"NJ-06",162584,117421,280005,58.06,41.94,-13.9,191260,138740,330000,57.96,42.04,-11.38
2012,"NJ-07",180577,176416,356993,50.58,49.42,1.05999999999999,239130,195267,434397,55.05,44.95,-5.55999999999999
2012,"NJ-08",174584,49660,224244,77.85,22.15,-53.48,183485,69455,252940,72.54,27.46,-40.54
2012,"NJ-09",177498,91382,268880,66.01,33.99,-29.8,199502,118023,317525,62.83,37.17,-21.12
2012,"NJ-10",233537,35144,268681,86.92,13.08,-71.62,255088,45586,300674,84.84,15.16,-65.14
2012,"NJ-11",182225,185602,367827,49.54,50.46,3.14000000000001,237533,207822,445355,53.34,46.66,-2.13999999999999
2012,"NJ-12",204675,100143,304818,67.15,32.85,-32.08,243136,113684,356820,68.14,31.86,-31.74
2014,"NJ-01",199095,118771,317866,62.63,37.37,-23.04,241889,142686,384575,62.9,37.1,-21.26
2014,"NJ-02",147536,162279,309815,47.62,52.38,6.98,183079,194136,377215,48.53,51.47,7.48000000000001
2014,"NJ-03",165200,187865,353065,46.79,53.21,8.64,217341,218266,435607,49.89,50.11,4.76000000000001
2014,"NJ-04",146253,198915,345168,42.37,57.63,17.48,191376,236900,428276,44.69,55.31,15.16
2014,"NJ-05",174044,178111,352155,49.42,50.58,3.38000000000001,224991,202446,427437,52.64,47.36,-0.739999999999995
2014,"NJ-06",162584,117421,280005,58.06,41.94,-13.9,191260,138740,330000,57.96,42.04,-11.38
2014,"NJ-07",180553,176400,356953,50.58,49.42,1.05999999999999,239099,195250,434349,55.05,44.95,-5.55999999999999
2014,"NJ-08",174559,49652,224211,77.85,22.15,-53.48,183456,69448,252904,72.54,27.46,-40.54
2014,"NJ-09",177514,91389,268903,66.01,33.99,-29.8,199521,118032,317553,62.83,37.17,-21.12
2014,"NJ-10",233562,35152,268714,86.92,13.08,-71.62,255119,45594,300713,84.84,15.16,-65.14
2014,"NJ-11",182238,185612,367850,49.54,50.46,3.14000000000001,237549,207831,445380,53.34,46.66,-2.13999999999999
2014,"NJ-12",204675,100143,304818,67.15,32.85,-32.08,243136,113684,356820,68.14,31.86,-31.74
2016,"NJ-01",199188,118814,318002,62.64,37.36,-23.06,241996,142738,384734,62.9,37.1,-21.26
2016,"NJ-02",147574,162348,309922,47.62,52.38,6.98,183132,194216,377348,48.53,51.47,7.48000000000001
2016,"NJ-03",165089,187822,352911,46.78,53.22,8.66,217241,218141,435382,49.9,50.1,4.74000000000001
2016,"NJ-04",146178,198860,345038,42.37,57.63,17.48,191254,236910,428164,44.67,55.33,15.2
2016,"NJ-05",173992,178062,352054,49.42,50.58,3.38000000000001,224937,202387,427324,52.64,47.36,-0.739999999999995
2016,"NJ-06",162725,117491,280216,58.07,41.93,-13.92,191409,138826,330235,57.96,42.04,-11.38
2016,"NJ-07",180496,176375,356871,50.58,49.42,1.05999999999999,239031,195215,434246,55.05,44.95,-5.55999999999999
2016,"NJ-08",174553,49637,224190,77.86,22.14,-53.5,183392,69439,252831,72.54,27.46,-40.54
2016,"NJ-09",177670,91505,269175,66.01,33.99,-29.8,199706,118180,317886,62.82,37.18,-21.1
2016,"NJ-10",233386,35005,268391,86.96,13.04,-71.7,254910,45415,300325,84.88,15.12,-65.22
2016,"NJ-11",182322,185685,368007,49.54,50.46,3.14000000000001,237700,207904,445604,53.34,46.66,-2.13999999999999
2016,"NJ-12",204693,100146,304839,67.15,32.85,-32.08,243161,113687,356848,68.14,31.86,-31.74
2018,"NJ-01",199188,118814,318002,62.64,37.36,-23.06,241996,142738,384734,62.9,37.1,-21.26
2018,"NJ-02",147574,162348,309922,47.62,52.38,6.98,183132,194216,377348,48.53,51.47,7.48000000000001
2018,"NJ-03",165089,187822,352911,46.78,53.22,8.66,217241,218141,435382,49.9,50.1,4.74000000000001
2018,"NJ-04",146178,198860,345038,42.37,57.63,17.48,191254,236910,428164,44.67,55.33,15.2
2018,"NJ-05",173992,178062,352054,49.42,50.58,3.38000000000001,224937,202387,427324,52.64,47.36,-0.739999999999995
2018,"NJ-06",162725,117491,280216,58.07,41.93,-13.92,191409,138826,330235,57.96,42.04,-11.38
2018,"NJ-07",180491,176369,356860,50.58,49.42,1.05999999999999,239024,195209,434233,55.05,44.95,-5.55999999999999
2018,"NJ-08",174553,49637,224190,77.86,22.14,-53.5,183392,69439,252831,72.54,27.46,-40.54
2018,"NJ-09",177670,91505,269175,66.01,33.99,-29.8,199706,118180,317886,62.82,37.18,-21.1
2018,"NJ-10",233386,35005,268391,86.96,13.04,-71.7,254910,45415,300325,84.88,15.12,-65.22
2018,"NJ-11",182325,185687,368012,49.54,50.46,3.14000000000001,237704,207906,445610,53.34,46.66,-2.13999999999999
2018,"NJ-12",204695,100150,304845,67.15,32.85,-32.08,243164,113691,356855,68.14,31.86,-31.74
2020,"NJ-01",199188,118814,318002,62.64,37.36,-23.06,241996,142738,384734,62.9,37.1,-21.26
2020,"NJ-02",147574,162348,309922,47.62,52.38,6.98,183132,194216,377348,48.53,51.47,7.48000000000001
2020,"NJ-03",165089,187822,352911,46.78,53.22,8.66,217241,218141,435382,49.9,50.1,4.74000000000001
2020,"NJ-04",146178,198860,345038,42.37,57.63,17.48,191254,236910,428164,44.67,55.33,15.2
2020,"NJ-05",173992,178062,352054,49.42,50.58,3.38000000000001,224937,202387,427324,52.64,47.36,-0.739999999999995
2020,"NJ-06",162725,117491,280216,58.07,41.93,-13.92,191409,138826,330235,57.96,42.04,-11.38
2020,"NJ-07",180491,176369,356860,50.58,49.42,1.05999999999999,239024,195209,434233,55.05,44.95,-5.55999999999999
2020,"NJ-08",174557,49639,224196,77.86,22.14,-53.5,183396,69441,252837,72.54,27.46,-40.54
2020,"NJ-09",177674,91508,269182,66.01,33.99,-29.8,199711,118184,317895,62.82,37.18,-21.1
2020,"NJ-10",233382,35003,268385,86.96,13.04,-71.7,254906,45413,300319,84.88,15.12,-65.22
2020,"NJ-11",182321,185684,368005,49.54,50.46,3.14000000000001,237699,207902,445601,53.34,46.66,-2.13999999999999
2020,"NJ-12",204695,100150,304845,67.15,32.85,-32.08,243164,113691,356855,68.14,31.86,-31.74
2022,"NJ-01",203379,124404,327783,62.05,37.95,-21.88,247622,149428,397050,62.37,37.63,-20.2
2022,"NJ-02",153459,177876,331335,46.32,53.68,9.58000000000001,192148,212916,405064,47.44,52.56,9.66
2022,"NJ-03",195397,160362,355759,54.92,45.08,-7.62,248204,186022,434226,57.16,42.84,-9.77999999999999
2022,"NJ-04",120273,217798,338071,35.58,64.42,31.06,163489,259764,423253,38.63,61.37,27.28
2022,"NJ-05",190401,162316,352717,53.98,46.02,-5.73999999999999,240324,186712,427036,56.28,43.72,-8.01999999999999
2022,"NJ-06",167934,112687,280621,59.84,40.16,-17.46,197347,131518,328865,60.01,39.99,-15.48
2022,"NJ-07",175684,197565,373249,47.07,52.93,8.08,236261,219141,455402,51.88,48.12,0.780000000000008
2022,"NJ-08",165689,46845,212534,77.96,22.04,-53.7,174742,65656,240398,72.69,27.31,-40.84
2022,"NJ-09",164406,99326,263732,62.34,37.66,-22.46,185129,125389,310518,59.62,40.38,-14.7
2022,"NJ-10",215242,42996,258238,83.35,16.65,-64.48,234120,53277,287397,81.46,18.54,-58.38
2022,"NJ-11",198637,158842,357479,55.57,44.43,-8.92,252599,178962,431561,58.53,41.47,-12.52
2022,"NJ-12",197359,100730,298089,66.21,33.79,-30.2,235882,114267,350149,67.37,32.63,-30.2
2008,"NM-01",149394,103252,252646,59.13,40.87,-16.04,200425,126830,327255,61.24,38.76,-17.94
2008,"NM-02",90770,112211,202981,44.72,55.28,12.78,112874,142289,255163,44.24,55.76,16.06
2008,"NM-03",145070,104204,249274,58.2,41.8,-14.18,188311,132774,321085,58.65,41.35,-12.76
2010,"NM-01",149394,103252,252646,59.13,40.87,-16.04,200425,126830,327255,61.24,38.76,-17.94
2010,"NM-02",90770,112211,202981,44.72,55.28,12.78,112874,142289,255163,44.24,55.76,16.06
2010,"NM-03",145070,104204,249274,58.2,41.8,-14.18,188311,132774,321085,58.65,41.35,-12.76
2012,"NM-01",147238,100120,247358,59.52,40.48,-16.82,197289,122685,319974,61.66,38.34,-18.78
2012,"NM-02",93365,117218,210583,44.34,55.66,13.54,116535,148611,265146,43.95,56.05,16.64
2012,"NM-03",144631,102329,246960,58.56,41.44,-14.9,187786,130597,318383,58.98,41.02,-13.42
2014,"NM-01",147238,100120,247358,59.52,40.48,-16.82,197289,122685,319974,61.66,38.34,-18.78
2014,"NM-02",93365,117218,210583,44.34,55.66,13.54,116535,148611,265146,43.95,56.05,16.64
2014,"NM-03",144631,102329,246960,58.56,41.44,-14.9,187786,130597,318383,58.98,41.02,-13.42
2016,"NM-01",147243,100127,247370,59.52,40.48,-16.82,197314,122702,320016,61.66,38.34,-18.78
2016,"NM-02",93362,117217,210579,44.34,55.66,13.54,116538,148612,265150,43.95,56.05,16.64
2016,"NM-03",144626,102322,246948,58.57,41.43,-14.92,187762,130580,318342,58.98,41.02,-13.42
2018,"NM-01",147224,100109,247333,59.52,40.48,-16.82,197301,122690,319991,61.66,38.34,-18.78
2018,"NM-02",93362,117217,210579,44.34,55.66,13.54,116538,148612,265150,43.95,56.05,16.64
2018,"NM-03",144645,102340,246985,58.56,41.44,-14.9,187775,130592,318367,58.98,41.02,-13.42
2020,"NM-01",147224,100109,247333,59.52,40.48,-16.82,197301,122690,319991,61.66,38.34,-18.78
2020,"NM-02",93362,117217,210579,44.34,55.66,13.54,116538,148612,265150,43.95,56.05,16.64
2020,"NM-03",144645,102340,246985,58.56,41.44,-14.9,187775,130592,318367,58.98,41.02,-13.42
2022,"NM-01",146499,121881,268380,54.59,45.41,-6.96,200279,148511,348790,57.42,42.58,-10.3
2022,"NM-02",107645,94376,202021,53.28,46.72,-4.34000000000001,138367,123161,261528,52.91,47.09,-1.28
2022,"NM-03",131087,103408,234495,55.9,44.1,-9.58000000000001,162968,130222,293190,55.58,44.42,-6.61999999999999
2008,"NY-01",139850,179689,319539,43.77,56.23,14.68,180123,195085,375208,48.01,51.99,8.52
2008,"NY-02",152625,137689,290314,52.57,47.43,-2.91999999999999,185523,149543,335066,55.37,44.63,-6.2
2008,"NY-03",133097,178595,311692,42.7,57.3,16.82,167138,196749,363887,45.93,54.07,12.68
2008,"NY-04",172630,119437,292067,59.11,40.89,-16,200190,134123,334313,59.88,40.12,-15.22
2008,"NY-05",133044,69441,202485,65.71,34.29,-29.2,147934,90457,238391,62.06,37.94,-19.58
2008,"NY-06",188454,22354,210808,89.4,10.6,-76.58,203604,34514,238118,85.51,14.49,-66.48
2008,"NY-07",160397,34546,194943,82.28,17.72,-62.34,170137,51000,221137,76.94,23.06,-49.34
2008,"NY-08",190124,54323,244447,77.78,22.22,-53.34,201845,73473,275318,73.31,26.69,-42.08
2008,"NY-09",118780,86078,204858,57.98,42.02,-13.74,132974,114660,247634,53.7,46.3,-2.85999999999999
2008,"NY-10",213849,15758,229607,93.14,6.86,-84.06,232051,29800,261851,88.62,11.38,-72.7
2008,"NY-11",212059,18222,230281,92.09,7.91,-81.96,232901,26313,259214,89.85,10.15,-75.16
2008,"NY-12",176904,20877,197781,89.44,10.56,-76.66,194847,35084,229931,84.74,15.26,-64.94
2008,"NY-13",105574,127366,232940,45.32,54.68,11.58,129509,154664,284173,45.57,54.43,13.4
2008,"NY-14",220057,41573,261630,84.11,15.89,-66,241317,49991,291308,82.84,17.16,-61.14
2008,"NY-15",230724,13123,243847,94.62,5.38,-87.02,230905,24534,255439,90.4,9.6,-76.26
2008,"NY-16",168153,8462,176615,95.21,4.79,-88.2,160662,25143,185805,86.47,13.53,-68.4
2008,"NY-17",176952,61203,238155,74.3,25.7,-46.38,186375,79928,266303,69.99,30.01,-35.44
2008,"NY-18",195469,98852,294321,66.41,33.59,-30.6,223902,107876,331778,67.49,32.51,-30.44
2008,"NY-19",148234,158859,307093,48.27,51.73,5.67999999999999,185828,174432,360260,51.58,48.42,1.38
2008,"NY-20",139833,165344,305177,45.82,54.18,10.58,186314,183444,369758,50.39,49.61,3.76000000000001
2008,"NY-21",153521,121248,274769,55.87,44.13,-9.52,187240,130917,318157,58.85,41.15,-13.16
2008,"NY-22",143487,117650,261137,54.95,45.05,-7.67999999999999,176702,126637,303339,58.25,41.75,-11.96
2008,"NY-23",95649,137452,233101,41.03,58.97,20.16,118048,160977,279025,42.31,57.69,19.92
2008,"NY-24",108197,141755,249952,43.29,56.71,15.64,132714,158152,290866,45.63,54.37,13.28
2008,"NY-25",153566,135495,289061,53.13,46.87,-4.04000000000001,192213,148491,340704,56.42,43.58,-8.29999999999999
2008,"NY-26",121736,178470,300206,40.55,59.45,21.12,157420,191412,348832,45.13,54.87,14.28
2008,"NY-27",123641,138393,262034,47.19,52.81,7.84,154645,148174,302819,51.07,48.93,2.4
2008,"NY-28",155832,79576,235408,66.2,33.8,-30.18,176297,83965,260262,67.74,32.26,-30.94
2008,"NY-29",123632,157648,281280,43.95,56.05,14.32,155462,172383,327845,47.42,52.58,9.70000000000001
2010,"NY-01",139850,179689,319539,43.77,56.23,14.68,180123,195085,375208,48.01,51.99,8.52
2010,"NY-02",152625,137689,290314,52.57,47.43,-2.91999999999999,185523,149543,335066,55.37,44.63,-6.2
2010,"NY-03",133097,178595,311692,42.7,57.3,16.82,167138,196749,363887,45.93,54.07,12.68
2010,"NY-04",172630,119437,292067,59.11,40.89,-16,200190,134123,334313,59.88,40.12,-15.22
2010,"NY-05",133044,69441,202485,65.71,34.29,-29.2,147934,90457,238391,62.06,37.94,-19.58
2010,"NY-06",188454,22354,210808,89.4,10.6,-76.58,203604,34514,238118,85.51,14.49,-66.48
2010,"NY-07",160397,34546,194943,82.28,17.72,-62.34,170137,51000,221137,76.94,23.06,-49.34
2010,"NY-08",190124,54323,244447,77.78,22.22,-53.34,201845,73473,275318,73.31,26.69,-42.08
2010,"NY-09",118780,86078,204858,57.98,42.02,-13.74,132974,114660,247634,53.7,46.3,-2.85999999999999
2010,"NY-10",213849,15758,229607,93.14,6.86,-84.06,232051,29800,261851,88.62,11.38,-72.7
2010,"NY-11",212059,18222,230281,92.09,7.91,-81.96,232901,26313,259214,89.85,10.15,-75.16
2010,"NY-12",176904,20877,197781,89.44,10.56,-76.66,194847,35084,229931,84.74,15.26,-64.94
2010,"NY-13",105574,127366,232940,45.32,54.68,11.58,129509,154664,284173,45.57,54.43,13.4
2010,"NY-14",220057,41573,261630,84.11,15.89,-66,241317,49991,291308,82.84,17.16,-61.14
2010,"NY-15",230724,13123,243847,94.62,5.38,-87.02,230905,24534,255439,90.4,9.6,-76.26
2010,"NY-16",168153,8462,176615,95.21,4.79,-88.2,160662,25143,185805,86.47,13.53,-68.4
2010,"NY-17",176952,61203,238155,74.3,25.7,-46.38,186375,79928,266303,69.99,30.01,-35.44
2010,"NY-18",195469,98852,294321,66.41,33.59,-30.6,223902,107876,331778,67.49,32.51,-30.44
2010,"NY-19",148234,158859,307093,48.27,51.73,5.67999999999999,185828,174432,360260,51.58,48.42,1.38
2010,"NY-20",139833,165344,305177,45.82,54.18,10.58,186314,183444,369758,50.39,49.61,3.76000000000001
2010,"NY-21",153521,121248,274769,55.87,44.13,-9.52,187240,130917,318157,58.85,41.15,-13.16
2010,"NY-22",143487,117650,261137,54.95,45.05,-7.67999999999999,176702,126637,303339,58.25,41.75,-11.96
2010,"NY-23",95649,137452,233101,41.03,58.97,20.16,118048,160977,279025,42.31,57.69,19.92
2010,"NY-24",108197,141755,249952,43.29,56.71,15.64,132714,158152,290866,45.63,54.37,13.28
2010,"NY-25",153566,135495,289061,53.13,46.87,-4.04000000000001,192213,148491,340704,56.42,43.58,-8.29999999999999
2010,"NY-26",121736,178470,300206,40.55,59.45,21.12,157420,191412,348832,45.13,54.87,14.28
2010,"NY-27",123641,138393,262034,47.19,52.81,7.84,154645,148174,302819,51.07,48.93,2.4
2010,"NY-28",155832,79576,235408,66.2,33.8,-30.18,176297,83965,260262,67.74,32.26,-30.94
2010,"NY-29",123632,157648,281280,43.95,56.05,14.32,155462,172383,327845,47.42,52.58,9.70000000000001
2012,"NY-01",141902,183232,325134,43.64,56.36,14.94,182794,198826,381620,47.9,52.1,8.74000000000001
2012,"NY-02",137683,165917,303600,45.35,54.65,11.52,168783,183213,351996,47.95,52.05,8.64000000000001
2012,"NY-03",178365,157001,335366,53.19,46.81,-4.16,216336,175145,391481,55.26,44.74,-5.97999999999999
2012,"NY-04",179788,147415,327203,54.95,45.05,-7.67999999999999,211630,165019,376649,56.19,43.81,-7.83999999999999
2012,"NY-05",211651,31324,242975,87.11,12.89,-72,229435,44496,273931,83.76,16.24,-62.98
2012,"NY-06",134885,66429,201314,67,33,-31.78,152650,92302,244952,62.32,37.68,-20.1
2012,"NY-07",177802,21220,199022,89.34,10.66,-76.46,190999,40395,231394,82.54,17.46,-60.54
2012,"NY-08",215694,34366,250060,86.26,13.74,-70.3,234957,46725,281682,83.41,16.59,-62.28
2012,"NY-09",211814,36593,248407,85.27,14.73,-68.32,232349,50863,283212,82.04,17.96,-59.54
2012,"NY-10",205119,49177,254296,80.66,19.34,-59.1,218171,65612,283783,76.88,23.12,-49.22
2012,"NY-11",108811,133233,242044,44.96,55.04,12.3,132368,163855,296223,44.69,55.31,15.16
2012,"NY-12",255514,41380,296894,86.06,13.94,-69.9,279860,49334,329194,85.01,14.99,-65.48
2012,"NY-13",232898,13728,246626,94.43,5.57,-86.64,233217,29520,262737,88.76,11.24,-72.98
2012,"NY-14",151570,38597,190167,79.7,20.3,-57.18,162149,57221,219370,73.92,26.08,-43.3
2012,"NY-15",179409,9368,188777,95.04,4.96,-87.86,171276,25850,197126,86.89,13.11,-69.24
2012,"NY-16",212562,63578,276140,76.98,23.02,-51.74,232685,73656,306341,75.96,24.04,-47.38
2012,"NY-17",186417,122313,308730,60.38,39.62,-18.54,212230,140296,352526,60.2,39.8,-15.86
2012,"NY-18",146163,152112,298275,49,51,4.22,184147,166413,350560,52.53,47.47,-0.519999999999996
2012,"NY-19",140553,162296,302849,46.41,53.59,9.4,183011,177607,360618,50.75,49.25,3.04000000000001
2012,"NY-20",175495,131655,307150,57.14,42.86,-12.06,217484,141717,359201,60.55,39.45,-16.56
2012,"NY-21",111612,150346,261958,42.61,57.39,17,141491,175208,316699,44.68,55.32,15.18
2012,"NY-22",114089,159011,273100,41.78,58.22,18.66,140083,177245,317328,44.14,55.86,16.26
2012,"NY-23",114801,157889,272690,42.1,57.9,18.02,138798,174989,313787,44.23,55.77,16.08
2012,"NY-24",151012,139741,290753,51.94,48.06,-1.66,186968,155194,342162,54.64,45.36,-4.73999999999999
2012,"NY-25",182901,128953,311854,58.65,41.35,-15.08,218508,137340,355848,61.4,38.6,-18.26
2012,"NY-26",175335,115560,290895,60.27,39.73,-18.32,209956,119412,329368,63.75,36.25,-22.96
2012,"NY-27",122234,207045,329279,37.12,62.88,27.98,162487,224469,386956,41.99,58.01,20.56
2014,"NY-01",141902,183232,325134,43.64,56.36,14.94,182794,198826,381620,47.9,52.1,8.74000000000001
2014,"NY-02",137683,165917,303600,45.35,54.65,11.52,168783,183213,351996,47.95,52.05,8.64000000000001
2014,"NY-03",178363,156998,335361,53.19,46.81,-4.16,216335,175150,391485,55.26,44.74,-5.97999999999999
2014,"NY-04",179779,147414,327193,54.95,45.05,-7.67999999999999,211624,165015,376639,56.19,43.81,-7.83999999999999
2014,"NY-05",211658,31336,242994,87.1,12.9,-71.98,229456,44514,273970,83.75,16.25,-62.96
2014,"NY-06",134947,66467,201414,67,33,-31.78,152695,92342,245037,62.32,37.68,-20.1
2014,"NY-07",177787,21220,199007,89.34,10.66,-76.46,190981,40396,231377,82.54,17.46,-60.54
2014,"NY-08",215669,34349,250018,86.26,13.74,-70.3,234945,46704,281649,83.42,16.58,-62.3
2014,"NY-09",211811,36594,248405,85.27,14.73,-68.32,232340,50865,283205,82.04,17.96,-59.54
2014,"NY-10",205100,49173,254273,80.66,19.34,-59.1,218154,65609,283763,76.88,23.12,-49.22
2014,"NY-11",108819,133236,242055,44.96,55.04,12.3,132378,163864,296242,44.69,55.31,15.16
2014,"NY-12",255542,41382,296924,86.06,13.94,-69.9,279883,49329,329212,85.02,14.98,-65.5
2014,"NY-13",232905,13728,246633,94.43,5.57,-86.64,233226,29523,262749,88.76,11.24,-72.98
2014,"NY-14",151549,38566,190115,79.71,20.29,-57.2,162130,57182,219312,73.93,26.07,-43.32
2014,"NY-15",179411,9369,188780,95.04,4.96,-87.86,171278,25849,197127,86.89,13.11,-69.24
2014,"NY-16",212541,63576,276117,76.97,23.03,-51.72,232659,73650,306309,75.96,24.04,-47.38
2014,"NY-17",186417,122313,308730,60.38,39.62,-18.54,212230,140296,352526,60.2,39.8,-15.86
2014,"NY-18",146163,152112,298275,49,51,4.22,184147,166413,350560,52.53,47.47,-0.519999999999996
2014,"NY-19",140553,162296,302849,46.41,53.59,9.4,183011,177607,360618,50.75,49.25,3.04000000000001
2014,"NY-20",175495,131655,307150,57.14,42.86,-12.06,217484,141717,359201,60.55,39.45,-16.56
2014,"NY-21",111612,150346,261958,42.61,57.39,17,141491,175208,316699,44.68,55.32,15.18
2014,"NY-22",114089,159011,273100,41.78,58.22,18.66,140083,177245,317328,44.14,55.86,16.26
2014,"NY-23",114801,157889,272690,42.1,57.9,18.02,138798,174989,313787,44.23,55.77,16.08
2014,"NY-24",151012,139741,290753,51.94,48.06,-1.66,186968,155194,342162,54.64,45.36,-4.73999999999999
2014,"NY-25",182901,128953,311854,58.65,41.35,-15.08,218508,137340,355848,61.4,38.6,-18.26
2014,"NY-26",175335,115560,290895,60.27,39.73,-18.32,209956,119412,329368,63.75,36.25,-22.96
2014,"NY-27",122234,207045,329279,37.12,62.88,27.98,162487,224469,386956,41.99,58.01,20.56
2016,"NY-01",141900,183227,325127,43.64,56.36,14.94,182791,198821,381612,47.9,52.1,8.74000000000001
2016,"NY-02",137685,165922,303607,45.35,54.65,11.52,168786,183218,352004,47.95,52.05,8.64000000000001
2016,"NY-03",178363,156998,335361,53.19,46.81,-4.16,216335,175150,391485,55.26,44.74,-5.97999999999999
2016,"NY-04",179779,147414,327193,54.95,45.05,-7.67999999999999,211624,165015,376639,56.19,43.81,-7.83999999999999
2016,"NY-05",211669,31340,243009,87.1,12.9,-71.98,229462,44515,273977,83.75,16.25,-62.96
2016,"NY-06",134936,66463,201399,67,33,-31.78,152689,92341,245030,62.31,37.69,-20.08
2016,"NY-07",177793,21220,199013,89.34,10.66,-76.46,190981,40396,231377,82.54,17.46,-60.54
2016,"NY-08",215663,34349,250012,86.26,13.74,-70.3,234945,46704,281649,83.42,16.58,-62.3
2016,"NY-09",211811,36594,248405,85.27,14.73,-68.32,232340,50865,283205,82.04,17.96,-59.54
2016,"NY-10",205100,49173,254273,80.66,19.34,-59.1,218154,65609,283763,76.88,23.12,-49.22
2016,"NY-11",108819,133236,242055,44.96,55.04,12.3,132378,163864,296242,44.69,55.31,15.16
2016,"NY-12",255542,41382,296924,86.06,13.94,-69.9,279883,49329,329212,85.02,14.98,-65.5
2016,"NY-13",232905,13728,246633,94.43,5.57,-86.64,233226,29523,262749,88.76,11.24,-72.98
2016,"NY-14",151549,38566,190115,79.71,20.29,-57.2,162130,57182,219312,73.93,26.07,-43.32
2016,"NY-15",179411,9369,188780,95.04,4.96,-87.86,171278,25849,197127,86.89,13.11,-69.24
2016,"NY-16",212541,63576,276117,76.97,23.03,-51.72,232659,73650,306309,75.96,24.04,-47.38
2016,"NY-17",186433,122330,308763,60.38,39.62,-18.54,212246,140311,352557,60.2,39.8,-15.86
2016,"NY-18",146169,152119,298288,49,51,4.22,184155,166421,350576,52.53,47.47,-0.519999999999996
2016,"NY-19",140553,162296,302849,46.41,53.59,9.4,183011,177607,360618,50.75,49.25,3.04000000000001
2016,"NY-20",175495,131655,307150,57.14,42.86,-12.06,217484,141717,359201,60.55,39.45,-16.56
2016,"NY-21",111612,150346,261958,42.61,57.39,17,141491,175208,316699,44.68,55.32,15.18
2016,"NY-22",114089,159011,273100,41.78,58.22,18.66,140083,177245,317328,44.14,55.86,16.26
2016,"NY-23",114801,157889,272690,42.1,57.9,18.02,138798,174989,313787,44.23,55.77,16.08
2016,"NY-24",151012,139741,290753,51.94,48.06,-1.66,186968,155194,342162,54.64,45.36,-4.73999999999999
2016,"NY-25",182901,128953,311854,58.65,41.35,-15.08,218508,137340,355848,61.4,38.6,-18.26
2016,"NY-26",175335,115560,290895,60.27,39.73,-18.32,209956,119412,329368,63.75,36.25,-22.96
2016,"NY-27",122234,207045,329279,37.12,62.88,27.98,162487,224469,386956,41.99,58.01,20.56
2018,"NY-01",141903,183233,325136,43.64,56.36,14.94,182795,198827,381622,47.9,52.1,8.74000000000001
2018,"NY-02",137687,165924,303611,45.35,54.65,11.52,168789,183221,352010,47.95,52.05,8.64000000000001
2018,"NY-03",178358,156990,335348,53.19,46.81,-4.16,216328,175141,391469,55.26,44.74,-5.97999999999999
2018,"NY-04",179777,147411,327188,54.95,45.05,-7.67999999999999,211621,165012,376633,56.19,43.81,-7.83999999999999
2018,"NY-05",211668,31342,243010,87.1,12.9,-71.98,229462,44517,273979,83.75,16.25,-62.96
2018,"NY-06",134936,66463,201399,67,33,-31.78,152689,92341,245030,62.31,37.69,-20.08
2018,"NY-07",177793,21220,199013,89.34,10.66,-76.46,190981,40396,231377,82.54,17.46,-60.54
2018,"NY-08",215665,34349,250014,86.26,13.74,-70.3,234946,46704,281650,83.42,16.58,-62.3
2018,"NY-09",211811,36594,248405,85.27,14.73,-68.32,232340,50865,283205,82.04,17.96,-59.54
2018,"NY-10",205096,49172,254268,80.66,19.34,-59.1,218149,65608,283757,76.88,23.12,-49.22
2018,"NY-11",108820,133237,242057,44.96,55.04,12.3,132380,163865,296245,44.69,55.31,15.16
2018,"NY-12",255546,41383,296929,86.06,13.94,-69.9,279888,49330,329218,85.02,14.98,-65.5
2018,"NY-13",232905,13728,246633,94.43,5.57,-86.64,233226,29523,262749,88.76,11.24,-72.98
2018,"NY-14",151549,38566,190115,79.71,20.29,-57.2,162130,57182,219312,73.93,26.07,-43.32
2018,"NY-15",179411,9369,188780,95.04,4.96,-87.86,171278,25849,197127,86.89,13.11,-69.24
2018,"NY-16",212541,63576,276117,76.97,23.03,-51.72,232659,73650,306309,75.96,24.04,-47.38
2018,"NY-17",186433,122330,308763,60.38,39.62,-18.54,212246,140311,352557,60.2,39.8,-15.86
2018,"NY-18",146169,152119,298288,49,51,4.22,184155,166421,350576,52.53,47.47,-0.519999999999996
2018,"NY-19",140553,162296,302849,46.41,53.59,9.4,183011,177607,360618,50.75,49.25,3.04000000000001
2018,"NY-20",175495,131655,307150,57.14,42.86,-12.06,217484,141717,359201,60.55,39.45,-16.56
2018,"NY-21",111612,150346,261958,42.61,57.39,17,141491,175208,316699,44.68,55.32,15.18
2018,"NY-22",114078,159001,273079,41.77,58.23,18.68,140068,177232,317300,44.14,55.86,16.26
2018,"NY-23",114812,157899,272711,42.1,57.9,18.02,138813,175002,313815,44.23,55.77,16.08
2018,"NY-24",151012,139741,290753,51.94,48.06,-1.66,186968,155194,342162,54.64,45.36,-4.73999999999999
2018,"NY-25",182901,128953,311854,58.65,41.35,-15.08,218508,137340,355848,61.4,38.6,-18.26
2018,"NY-26",175340,115569,290909,60.27,39.73,-18.32,209963,119421,329384,63.74,36.26,-22.94
2018,"NY-27",122229,207036,329265,37.12,62.88,27.98,162480,224460,386940,41.99,58.01,20.56
2020,"NY-01",141911,183249,325160,43.64,56.36,14.94,182805,198845,381650,47.9,52.1,8.74000000000001
2020,"NY-02",137682,165912,303594,45.35,54.65,11.52,168783,183207,351990,47.95,52.05,8.64000000000001
2020,"NY-03",178315,156947,335262,53.19,46.81,-4.16,216277,175097,391374,55.26,44.74,-5.97999999999999
2020,"NY-04",179781,147452,327233,54.94,45.06,-7.66,211637,165060,376697,56.18,43.82,-7.81999999999999
2020,"NY-05",211700,31337,243037,87.11,12.89,-72,229492,44509,274001,83.76,16.24,-62.98
2020,"NY-06",134936,66463,201399,67,33,-31.78,152689,92341,245030,62.31,37.69,-20.08
2020,"NY-07",177797,21220,199017,89.34,10.66,-76.46,190991,40399,231390,82.54,17.46,-60.54
2020,"NY-08",215665,34349,250014,86.26,13.74,-70.3,234946,46704,281650,83.42,16.58,-62.3
2020,"NY-09",211811,36594,248405,85.27,14.73,-68.32,232340,50865,283205,82.04,17.96,-59.54
2020,"NY-10",205092,49172,254264,80.66,19.34,-59.1,218138,65604,283742,76.88,23.12,-49.22
2020,"NY-11",108820,133237,242057,44.96,55.04,12.3,132381,163866,296247,44.69,55.31,15.16
2020,"NY-12",255546,41383,296929,86.06,13.94,-69.9,279888,49330,329218,85.02,14.98,-65.5
2020,"NY-13",232917,13729,246646,94.43,5.57,-86.64,233236,29525,262761,88.76,11.24,-72.98
2020,"NY-14",151533,38562,190095,79.71,20.29,-57.2,162118,57178,219296,73.93,26.07,-43.32
2020,"NY-15",179411,9369,188780,95.04,4.96,-87.86,171278,25849,197127,86.89,13.11,-69.24
2020,"NY-16",212572,63583,276155,76.98,23.02,-51.74,232691,73653,306344,75.96,24.04,-47.38
2020,"NY-17",186373,122304,308677,60.38,39.62,-18.54,212179,140286,352465,60.2,39.8,-15.86
2020,"NY-18",146191,152128,298319,49,51,4.22,184181,166432,350613,52.53,47.47,-0.519999999999996
2020,"NY-19",140563,162308,302871,46.41,53.59,9.4,183025,177619,360644,50.75,49.25,3.04000000000001
2020,"NY-20",175495,131655,307150,57.14,42.86,-12.06,217484,141717,359201,60.55,39.45,-16.56
2020,"NY-21",111612,150346,261958,42.61,57.39,17,141491,175208,316699,44.68,55.32,15.18
2020,"NY-22",114061,158979,273040,41.77,58.23,18.68,140045,177210,317255,44.14,55.86,16.26
2020,"NY-23",114833,157927,272760,42.1,57.9,18.02,138841,175030,313871,44.24,55.76,16.06
2020,"NY-24",151012,139741,290753,51.94,48.06,-1.66,186968,155194,342162,54.64,45.36,-4.73999999999999
2020,"NY-25",182901,128953,311854,58.65,41.35,-15.08,218508,137340,355848,61.4,38.6,-18.26
2020,"NY-26",175340,115569,290909,60.27,39.73,-18.32,209963,119421,329384,63.74,36.26,-22.94
2020,"NY-27",122229,207036,329265,37.12,62.88,27.98,162480,224460,386940,41.99,58.01,20.56
2022,"NY-01",165582,195357,360939,45.88,54.12,10.46,212148,211236,423384,50.11,49.89,4.32000000000001
2022,"NY-02",143766,164880,308646,46.58,53.42,9.06,175554,180970,356524,49.24,50.76,6.06000000000001
2022,"NY-03",176880,158996,335876,52.66,47.34,-3.1,213365,180843,394208,54.12,45.88,-3.7
2022,"NY-04",191203,148777,339980,56.24,43.76,-10.26,223917,166546,390463,57.35,42.65,-10.16
2022,"NY-05",199968,34313,234281,85.35,14.65,-68.48,216295,49447,265742,81.39,18.61,-58.24
2022,"NY-06",140495,57322,197817,71.02,28.98,-39.82,155744,82793,238537,65.29,34.71,-26.04
2022,"NY-07",186652,26467,213119,87.58,12.42,-72.94,207154,46907,254061,81.54,18.46,-58.54
2022,"NY-08",181954,42590,224544,81.03,18.97,-59.84,194955,58921,253876,76.79,23.21,-49.04
2022,"NY-09",184172,44876,229048,80.41,19.59,-58.6,202531,64210,266741,75.93,24.07,-47.32
2022,"NY-10",227730,28789,256519,88.78,11.22,-75.34,245101,39946,285047,85.99,14.01,-67.44
2022,"NY-11",109882,129361,239243,45.93,54.07,10.36,134608,157160,291768,46.14,53.86,12.26
2022,"NY-12",271357,41631,312988,86.7,13.3,-71.18,291464,47248,338712,86.05,13.95,-67.56
2022,"NY-13",243934,13959,257893,94.59,5.41,-86.96,242289,30461,272750,88.83,11.17,-73.12
2022,"NY-14",171488,32219,203707,84.18,15.82,-66.14,181045,49609,230654,78.49,21.51,-52.44
2022,"NY-15",186182,16803,202985,91.72,8.28,-81.22,182651,31693,214344,85.21,14.79,-65.88
2022,"NY-16",209145,80207,289352,72.28,27.72,-42.34,233396,90446,323842,72.07,27.93,-39.6
2022,"NY-17",179258,151592,330850,54.18,45.82,-6.13999999999999,210251,171524,381775,55.07,44.93,-5.59999999999999
2022,"NY-18",151945,149293,301238,50.44,49.56,1.34,193311,163031,356342,54.25,45.75,-3.95999999999999
2022,"NY-19",155489,161043,316532,49.12,50.88,3.98,193490,176022,369512,52.36,47.64,-0.179999999999986
2022,"NY-20",180324,139693,320017,56.35,43.65,-10.48,225872,151936,377808,59.78,40.22,-15.02
2022,"NY-21",125137,175784,300921,41.58,58.42,19.06,156203,201346,357549,43.69,56.31,17.16
2022,"NY-22",157846,151286,309132,51.06,48.94,0.0999999999999943,195894,168286,364180,53.79,46.21,-3.04
2022,"NY-23",126116,212459,338575,37.25,62.75,27.72,162410,231516,393926,41.23,58.77,22.08
2022,"NY-24",120348,191984,312332,38.53,61.47,25.16,150765,215108,365873,41.21,58.79,22.12
2022,"NY-25",190546,141993,332539,57.3,42.7,-12.38,228228,151735,379963,60.07,39.93,-15.6
2022,"NY-26",178704,127828,306532,58.3,41.7,-14.38,216204,133012,349216,61.91,38.09,-19.28
2008,"NC-01",165922,107089,273011,60.77,39.23,-19.32,171170,121124,292294,58.56,41.44,-12.58
2008,"NC-02",159548,161564,321112,49.69,50.31,2.84,192202,197054,389256,49.38,50.62,5.78
2008,"NC-03",112665,212365,325030,34.66,65.34,32.9,138692,242887,381579,36.35,63.65,31.84
2008,"NC-04",324969,161447,486416,66.81,33.19,-31.4,406215,185804,592019,68.62,31.38,-32.7
2008,"NC-05",112909,224874,337783,33.43,66.57,35.36,140418,258652,399070,35.19,64.81,34.16
2008,"NC-06",118450,237477,355927,33.28,66.72,35.66,153902,273454,427356,36.01,63.99,32.52
2008,"NC-07",146935,198049,344984,42.59,57.41,17.04,179806,241397,421203,42.69,57.31,19.16
2008,"NC-08",150826,145572,296398,50.89,49.11,0.439999999999998,182000,169691,351691,51.75,48.25,1.04000000000001
2008,"NC-09",208613,234424,443037,47.09,52.91,8.04000000000001,285418,272340,557758,51.17,48.83,2.2
2008,"NC-10",89204,224689,313893,28.42,71.58,45.38,111922,269160,381082,29.37,70.63,45.8
2008,"NC-11",151272,207996,359268,42.11,57.89,18,193350,237569,430919,44.87,55.13,14.8
2008,"NC-12",225311,99838,325149,69.29,30.71,-36.36,261191,117868,379059,68.91,31.09,-33.28
2008,"NC-13",222692,147246,369938,60.2,39.8,-18.18,267986,171739,439725,60.94,39.06,-17.34
2010,"NC-01",165922,107089,273011,60.77,39.23,-19.32,171170,121124,292294,58.56,41.44,-12.58
2010,"NC-02",159548,161564,321112,49.69,50.31,2.84,192202,197054,389256,49.38,50.62,5.78
2010,"NC-03",112665,212365,325030,34.66,65.34,32.9,138692,242887,381579,36.35,63.65,31.84
2010,"NC-04",324969,161447,486416,66.81,33.19,-31.4,406215,185804,592019,68.62,31.38,-32.7
2010,"NC-05",112909,224874,337783,33.43,66.57,35.36,140418,258652,399070,35.19,64.81,34.16
2010,"NC-06",118450,237477,355927,33.28,66.72,35.66,153902,273454,427356,36.01,63.99,32.52
2010,"NC-07",146935,198049,344984,42.59,57.41,17.04,179806,241397,421203,42.69,57.31,19.16
2010,"NC-08",150826,145572,296398,50.89,49.11,0.439999999999998,182000,169691,351691,51.75,48.25,1.04000000000001
2010,"NC-09",208613,234424,443037,47.09,52.91,8.04000000000001,285418,272340,557758,51.17,48.83,2.2
2010,"NC-10",89204,224689,313893,28.42,71.58,45.38,111922,269160,381082,29.37,70.63,45.8
2010,"NC-11",151272,207996,359268,42.11,57.89,18,193350,237569,430919,44.87,55.13,14.8
2010,"NC-12",225311,99838,325149,69.29,30.71,-36.36,261191,117868,379059,68.91,31.09,-33.28
2010,"NC-13",222692,147246,369938,60.2,39.8,-18.18,267986,171739,439725,60.94,39.06,-17.34
2012,"NC-01",231208,93723,324931,71.16,28.84,-40.1,245572,106774,352346,69.7,30.3,-34.86
2012,"NC-02",140118,190760,330878,42.35,57.65,17.52,185096,227959,413055,44.81,55.19,14.92
2012,"NC-03",123965,196976,320941,38.63,61.37,24.96,149039,227466,376505,39.58,60.42,25.38
2012,"NC-04",273694,87886,361580,75.69,24.31,-49.16,315838,101071,416909,75.76,24.24,-46.98
2012,"NC-05",138619,216902,355521,38.99,61.01,24.24,169762,248174,417936,40.62,59.38,23.3
2012,"NC-06",157792,216709,374501,42.13,57.87,17.96,194951,245642,440593,44.25,55.75,16.04
2012,"NC-07",136420,224367,360787,37.81,62.19,26.6,177239,272704,449943,39.39,60.61,25.76
2012,"NC-08",112605,197476,310081,36.31,63.69,29.6,135714,234325,370039,36.68,63.32,31.18
2012,"NC-09",192239,207017,399256,48.15,51.85,5.91999999999999,267248,241613,508861,52.52,47.48,-0.5
2012,"NC-10",132855,215873,348728,38.1,61.9,26.02,165256,253758,419014,39.44,60.56,25.66
2012,"NC-11",118238,234045,352283,33.56,66.44,35.1,152308,271443,423751,35.94,64.06,32.66
2012,"NC-12",239701,69236,308937,77.59,22.41,-52.96,272976,83617,356593,76.55,23.45,-48.56
2012,"NC-13",191845,211627,403472,47.55,52.45,7.12,253220,244170,497390,50.91,49.09,2.72000000000001
2014,"NC-01",231208,93723,324931,71.16,28.84,-40.1,245572,106774,352346,69.7,30.3,-34.86
2014,"NC-02",140118,190760,330878,42.35,57.65,17.52,185096,227959,413055,44.81,55.19,14.92
2014,"NC-03",123965,196976,320941,38.63,61.37,24.96,149039,227466,376505,39.58,60.42,25.38
2014,"NC-04",273694,87886,361580,75.69,24.31,-49.16,315838,101071,416909,75.76,24.24,-46.98
2014,"NC-05",138619,216902,355521,38.99,61.01,24.24,169762,248174,417936,40.62,59.38,23.3
2014,"NC-06",157792,216709,374501,42.13,57.87,17.96,194951,245642,440593,44.25,55.75,16.04
2014,"NC-07",136420,224367,360787,37.81,62.19,26.6,177239,272704,449943,39.39,60.61,25.76
2014,"NC-08",112605,197476,310081,36.31,63.69,29.6,135714,234325,370039,36.68,63.32,31.18
2014,"NC-09",192239,207017,399256,48.15,51.85,5.91999999999999,267248,241613,508861,52.52,47.48,-0.5
2014,"NC-10",132855,215873,348728,38.1,61.9,26.02,165256,253758,419014,39.44,60.56,25.66
2014,"NC-11",118238,234045,352283,33.56,66.44,35.1,152308,271443,423751,35.94,64.06,32.66
2014,"NC-12",239701,69236,308937,77.59,22.41,-52.96,272976,83617,356593,76.55,23.45,-48.56
2014,"NC-13",191845,211627,403472,47.55,52.45,7.12,253220,244170,497390,50.91,49.09,2.72000000000001
2016,"NC-01",239785,108344,348129,68.88,31.12,-35.54,261736,122024,383760,68.2,31.8,-31.86
2016,"NC-02",172894,211268,384162,45.01,54.99,12.2,238158,257103,495261,48.09,51.91,8.36000000000001
2016,"NC-03",121054,198864,319918,37.84,62.16,26.54,146174,230355,376529,38.82,61.18,26.9
2016,"NC-04",281565,116358,397923,70.76,29.24,-39.3,338279,128645,466924,72.45,27.55,-40.36
2016,"NC-05",142372,205333,347705,40.95,59.05,20.32,169535,234136,403671,42,58,20.54
2016,"NC-06",148684,201371,350055,42.47,57.53,17.28,180614,235922,416536,43.36,56.64,17.82
2016,"NC-07",142909,206183,349092,40.94,59.06,20.34,176367,246102,422469,41.75,58.25,21.04
2016,"NC-08",136279,185863,322142,42.3,57.7,17.62,173447,218000,391447,44.31,55.69,15.92
2016,"NC-09",147106,186957,334063,44.04,55.96,14.14,182192,220781,402973,45.21,54.79,14.12
2016,"NC-10",129443,217271,346714,37.33,62.67,27.56,160828,255665,416493,38.61,61.39,27.32
2016,"NC-11",123788,230007,353795,34.99,65.01,32.24,158879,266803,425682,37.32,62.68,29.9
2016,"NC-12",243520,100972,344492,70.69,29.31,-39.16,309096,119575,428671,72.11,27.89,-39.68
2016,"NC-13",159908,193824,353732,45.21,54.79,11.8,188933,223638,412571,45.79,54.21,12.96
2018,"NC-01",239779,108334,348113,68.88,31.12,-35.54,261720,122016,383736,68.2,31.8,-31.86
2018,"NC-02",172894,211268,384162,45.01,54.99,12.2,238161,257108,495269,48.09,51.91,8.36000000000001
2018,"NC-03",121058,198879,319937,37.84,62.16,26.54,146179,230372,376551,38.82,61.18,26.9
2018,"NC-04",281537,116341,397878,70.76,29.24,-39.3,338272,128634,466906,72.45,27.55,-40.36
2018,"NC-05",142291,205261,347552,40.94,59.06,20.34,169509,234070,403579,42,58,20.54
2018,"NC-06",148712,201388,350100,42.48,57.52,17.26,180634,235935,416569,43.36,56.64,17.82
2018,"NC-07",142908,206175,349083,40.94,59.06,20.34,176369,246096,422465,41.75,58.25,21.04
2018,"NC-08",136279,185863,322142,42.3,57.7,17.62,173447,218000,391447,44.31,55.69,15.92
2018,"NC-09",147103,186954,334057,44.04,55.96,14.14,182185,220771,402956,45.21,54.79,14.12
2018,"NC-10",129418,217226,346644,37.33,62.67,27.56,160801,255669,416470,38.61,61.39,27.32
2018,"NC-11",123788,229993,353781,34.99,65.01,32.24,158865,266780,425645,37.32,62.68,29.9
2018,"NC-12",243516,101073,344589,70.67,29.33,-39.12,309304,119787,429091,72.08,27.92,-39.62
2018,"NC-13",159916,193770,353686,45.21,54.79,11.8,188846,223537,412383,45.79,54.21,12.96
2020,"NC-01",239779,108334,348113,68.88,31.12,-35.54,261720,122016,383736,68.2,31.8,-31.86
2020,"NC-02",172873,211239,384112,45.01,54.99,12.2,238089,257084,495173,48.08,51.92,8.38000000000001
2020,"NC-03",121058,198879,319937,37.84,62.16,26.54,146179,230372,376551,38.82,61.18,26.9
2020,"NC-04",281545,116354,397899,70.76,29.24,-39.3,338272,128634,466906,72.45,27.55,-40.36
2020,"NC-05",142291,205261,347552,40.94,59.06,20.34,169509,234070,403579,42,58,20.54
2020,"NC-06",148712,201388,350100,42.48,57.52,17.26,180634,235935,416569,43.36,56.64,17.82
2020,"NC-07",142908,206175,349083,40.94,59.06,20.34,176369,246096,422465,41.75,58.25,21.04
2020,"NC-08",136304,185886,322190,42.31,57.69,17.6,173522,218018,391540,44.32,55.68,15.9
2020,"NC-09",147119,186974,334093,44.04,55.96,14.14,182205,220793,402998,45.21,54.79,14.12
2020,"NC-10",129418,217226,346644,37.33,62.67,27.56,160801,255669,416470,38.61,61.39,27.32
2020,"NC-11",123786,229989,353775,34.99,65.01,32.24,158865,266780,425645,37.32,62.68,29.9
2020,"NC-12",243516,101073,344589,70.67,29.33,-39.12,309304,119787,429091,72.08,27.92,-39.62
2020,"NC-13",159896,193756,353652,45.21,54.79,11.8,188823,223521,412344,45.79,54.21,12.96
2022,"NC-01",194359,158650,353009,55.06,44.94,-7.89999999999999,208354,179755,388109,53.68,46.32,-2.82
2022,"NC-02",204376,127025,331401,61.67,38.33,-21.12,263763,144377,408140,64.63,35.37,-24.72
2022,"NC-03",112742,195877,308619,36.53,63.47,29.16,134419,227416,361835,37.15,62.85,30.24
2022,"NC-04",231993,110652,342645,67.71,32.29,-33.2,270311,128658,398969,67.75,32.25,-30.96
2022,"NC-05",130764,210774,341538,38.29,61.71,25.64,156371,242122,398493,39.24,60.76,26.06
2022,"NC-06",188282,151466,339748,55.42,44.58,-8.62,217813,169234,387047,56.28,43.72,-8.01999999999999
2022,"NC-07",142451,186366,328817,43.32,56.68,15.58,175778,227531,403309,43.58,56.42,17.38
2022,"NC-08",100640,221139,321779,31.28,68.72,39.66,127278,261370,388648,32.75,67.25,39.04
2022,"NC-09",133952,158981,292933,45.73,54.27,10.76,160923,189334,350257,45.94,54.06,12.66
2022,"NC-10",94882,229714,324596,29.23,70.77,43.76,117798,274766,392564,30.01,69.99,44.52
2022,"NC-11",150107,206807,356914,42.06,57.94,18.1,192275,236433,428708,44.85,55.15,14.84
2022,"NC-12",184083,108611,292694,62.89,37.11,-23.56,235794,125423,361217,65.28,34.72,-26.02
2022,"NC-13",151101,158541,309642,48.8,51.2,4.62,198777,191878,390655,50.88,49.12,2.78000000000001
2022,"NC-14",169476,137932,307408,55.13,44.87,-8.04000000000001,224635,160462,385097,58.33,41.67,-12.12
2008,"ND-01",93630,216659,310289,30.18,69.82,41.86,114891,235621,350512,32.78,67.22,38.98
2010,"ND-01",93630,216659,310289,30.18,69.82,41.86,114891,235621,350512,32.78,67.22,38.98
2012,"ND-01",93630,216659,310289,30.18,69.82,41.86,114891,235621,350512,32.78,67.22,38.98
2014,"ND-01",93630,216659,310289,30.18,69.82,41.86,114891,235621,350512,32.78,67.22,38.98
2016,"ND-01",93644,216674,310318,30.18,69.82,41.86,114908,235636,350544,32.78,67.22,38.98
2018,"ND-01",93758,216794,310552,30.19,69.81,41.84,115042,235751,350793,32.79,67.21,38.96
2020,"ND-01",93758,216794,310552,30.19,69.81,41.84,115042,235751,350793,32.79,67.21,38.96
2022,"ND-01",93758,216794,310552,30.19,69.81,41.84,115042,235751,350793,32.79,67.21,38.96
2008,"OH-01",151786,124412,276198,54.96,45.04,-7.7,166328,128542,294870,56.41,43.59,-8.27999999999999
2008,"OH-02",126107,204883,330990,38.1,61.9,26.02,155479,223099,378578,41.07,58.93,22.4
2008,"OH-03",131968,173919,305887,43.14,56.86,15.94,150010,187082,337092,44.5,55.5,15.54
2008,"OH-04",72369,198486,270855,26.72,73.28,48.78,79571,222005,301576,26.39,73.61,51.76
2008,"OH-05",90706,189978,280684,32.32,67.68,37.58,100257,214486,314743,31.85,68.15,40.84
2008,"OH-06",90274,185394,275668,32.75,67.25,36.72,94361,203350,297711,31.7,68.3,41.14
2008,"OH-07",118789,183044,301833,39.36,60.64,23.5,135588,206015,341603,39.69,60.31,25.16
2008,"OH-08",95201,201593,296794,32.08,67.92,38.06,110968,218162,329130,33.72,66.28,37.1
2008,"OH-09",148058,121856,269914,54.85,45.15,-7.48,155177,135124,290301,53.45,46.55,-2.35999999999999
2008,"OH-10",145826,107467,253293,57.57,42.43,-12.92,162298,118673,280971,57.76,42.24,-10.98
2008,"OH-11",208590,32479,241069,86.53,13.47,-70.84,201479,36168,237647,84.78,15.22,-65.02
2008,"OH-12",217563,167128,384691,56.56,43.44,-10.9,266271,185737,452008,58.91,41.09,-13.28
2008,"OH-13",151976,145287,297263,51.13,48.87,-0.039999999999992,172928,166637,339565,50.93,49.07,2.68000000000001
2008,"OH-14",137485,177298,314783,43.68,56.32,14.86,164050,200311,364361,45.02,54.98,14.5
2008,"OH-15",179902,136825,316727,56.8,43.2,-11.38,212217,148117,360334,58.89,41.11,-13.24
2008,"OH-16",109018,180658,289676,37.63,62.37,26.96,124337,205076,329413,37.75,62.25,29.04
2008,"OH-17",132472,123531,256003,51.75,48.25,-1.27999999999999,136737,139547,276284,49.49,50.51,5.56
2008,"OH-18",78250,183445,261695,29.9,70.1,42.42,82469,213088,295557,27.9,72.1,48.74
2010,"OH-01",151786,124412,276198,54.96,45.04,-7.7,166328,128542,294870,56.41,43.59,-8.27999999999999
2010,"OH-02",126107,204883,330990,38.1,61.9,26.02,155479,223099,378578,41.07,58.93,22.4
2010,"OH-03",131968,173919,305887,43.14,56.86,15.94,150010,187082,337092,44.5,55.5,15.54
2010,"OH-04",72369,198486,270855,26.72,73.28,48.78,79571,222005,301576,26.39,73.61,51.76
2010,"OH-05",90706,189978,280684,32.32,67.68,37.58,100257,214486,314743,31.85,68.15,40.84
2010,"OH-06",90274,185394,275668,32.75,67.25,36.72,94361,203350,297711,31.7,68.3,41.14
2010,"OH-07",118789,183044,301833,39.36,60.64,23.5,135588,206015,341603,39.69,60.31,25.16
2010,"OH-08",95201,201593,296794,32.08,67.92,38.06,110968,218162,329130,33.72,66.28,37.1
2010,"OH-09",148058,121856,269914,54.85,45.15,-7.48,155177,135124,290301,53.45,46.55,-2.35999999999999
2010,"OH-10",145826,107467,253293,57.57,42.43,-12.92,162298,118673,280971,57.76,42.24,-10.98
2010,"OH-11",208590,32479,241069,86.53,13.47,-70.84,201479,36168,237647,84.78,15.22,-65.02
2010,"OH-12",217563,167128,384691,56.56,43.44,-10.9,266271,185737,452008,58.91,41.09,-13.28
2010,"OH-13",151976,145287,297263,51.13,48.87,-0.039999999999992,172928,166637,339565,50.93,49.07,2.68000000000001
2010,"OH-14",137485,177298,314783,43.68,56.32,14.86,164050,200311,364361,45.02,54.98,14.5
2010,"OH-15",179902,136825,316727,56.8,43.2,-11.38,212217,148117,360334,58.89,41.11,-13.24
2010,"OH-16",109018,180658,289676,37.63,62.37,26.96,124337,205076,329413,37.75,62.25,29.04
2010,"OH-17",132472,123531,256003,51.75,48.25,-1.27999999999999,136737,139547,276284,49.49,50.51,5.56
2010,"OH-18",78250,183445,261695,29.9,70.1,42.42,82469,213088,295557,27.9,72.1,48.74
2012,"OH-01",160785,184997,345782,46.5,53.5,9.22,185722,198487,384209,48.34,51.66,7.86000000000001
2012,"OH-02",140964,197880,338844,41.6,58.4,19.02,165792,214526,380318,43.59,56.41,17.36
2012,"OH-03",209699,89608,299307,70.06,29.94,-37.9,230806,93766,324572,71.11,28.89,-37.68
2012,"OH-04",99795,209168,308963,32.3,67.7,37.62,110508,237637,348145,31.74,68.26,41.06
2012,"OH-05",124133,214237,338370,36.69,63.31,28.84,141202,237298,378500,37.31,62.69,29.92
2012,"OH-06",85489,221775,307264,27.82,72.18,46.58,91264,248434,339698,26.87,73.13,50.8
2012,"OH-07",107830,205293,313123,34.44,65.56,33.34,120509,237063,357572,33.7,66.3,37.14
2012,"OH-08",104946,223196,328142,31.98,68.02,38.26,119867,243049,362916,33.03,66.97,38.48
2012,"OH-09",177215,110281,287496,61.64,38.36,-21.06,184451,124640,309091,59.68,40.32,-14.82
2012,"OH-10",153297,178667,331964,46.18,53.82,9.86,172422,188499,360921,47.77,52.23,9
2012,"OH-11",260574,55272,315846,82.5,17.5,-62.78,253011,61165,314176,80.53,19.47,-56.52
2012,"OH-12",162497,205867,368364,44.11,55.89,14,206180,232679,438859,46.98,53.02,10.58
2012,"OH-13",163273,142578,305851,53.38,46.62,-4.54000000000001,171015,159754,330769,51.7,48.3,1.14
2012,"OH-14",155600,197864,353464,44.02,55.98,14.18,185627,222915,408542,45.44,54.56,13.66
2012,"OH-15",142082,196751,338833,41.93,58.07,18.36,166749,222215,388964,42.87,57.13,18.8
2012,"OH-16",145975,207555,353530,41.29,58.71,19.64,174021,232688,406709,42.79,57.21,18.96
2014,"OH-01",160787,185000,345787,46.5,53.5,9.22,185725,198489,384214,48.34,51.66,7.86000000000001
2014,"OH-02",140962,197877,338839,41.6,58.4,19.02,165789,214524,380313,43.59,56.41,17.36
2014,"OH-03",209708,89616,299324,70.06,29.94,-37.9,230810,93769,324579,71.11,28.89,-37.68
2014,"OH-04",99795,209168,308963,32.3,67.7,37.62,110508,237637,348145,31.74,68.26,41.06
2014,"OH-05",124133,214237,338370,36.69,63.31,28.84,141202,237298,378500,37.31,62.69,29.92
2014,"OH-06",85489,221775,307264,27.82,72.18,46.58,91264,248434,339698,26.87,73.13,50.8
2014,"OH-07",107830,205293,313123,34.44,65.56,33.34,120509,237063,357572,33.7,66.3,37.14
2014,"OH-08",104946,223196,328142,31.98,68.02,38.26,119867,243049,362916,33.03,66.97,38.48
2014,"OH-09",177215,110281,287496,61.64,38.36,-21.06,184451,124640,309091,59.68,40.32,-14.82
2014,"OH-10",153297,178667,331964,46.18,53.82,9.86,172422,188499,360921,47.77,52.23,9
2014,"OH-11",260574,55272,315846,82.5,17.5,-62.78,253011,61165,314176,80.53,19.47,-56.52
2014,"OH-12",162491,205861,368352,44.11,55.89,14,206180,232679,438859,46.98,53.02,10.58
2014,"OH-13",163273,142578,305851,53.38,46.62,-4.54000000000001,171015,159754,330769,51.7,48.3,1.14
2014,"OH-14",155600,197864,353464,44.02,55.98,14.18,185627,222915,408542,45.44,54.56,13.66
2014,"OH-15",142079,196749,338828,41.93,58.07,18.36,166745,222212,388957,42.87,57.13,18.8
2014,"OH-16",145975,207555,353530,41.29,58.71,19.64,174021,232688,406709,42.79,57.21,18.96
2016,"OH-01",160787,185000,345787,46.5,53.5,9.22,185725,198489,384214,48.34,51.66,7.86000000000001
2016,"OH-02",140962,197877,338839,41.6,58.4,19.02,165789,214524,380313,43.59,56.41,17.36
2016,"OH-03",209674,89601,299275,70.06,29.94,-37.9,230777,93760,324537,71.11,28.89,-37.68
2016,"OH-04",99795,209168,308963,32.3,67.7,37.62,110508,237637,348145,31.74,68.26,41.06
2016,"OH-05",124133,214237,338370,36.69,63.31,28.84,141202,237298,378500,37.31,62.69,29.92
2016,"OH-06",85490,221777,307267,27.82,72.18,46.58,91265,248436,339701,26.87,73.13,50.8
2016,"OH-07",107830,205293,313123,34.44,65.56,33.34,120509,237063,357572,33.7,66.3,37.14
2016,"OH-08",104946,223196,328142,31.98,68.02,38.26,119867,243049,362916,33.03,66.97,38.48
2016,"OH-09",177215,110281,287496,61.64,38.36,-21.06,184451,124640,309091,59.68,40.32,-14.82
2016,"OH-10",153297,178667,331964,46.18,53.82,9.86,172422,188499,360921,47.77,52.23,9
2016,"OH-11",260573,55270,315843,82.5,17.5,-62.78,253010,61164,314174,80.53,19.47,-56.52
2016,"OH-12",162521,205872,368393,44.12,55.88,13.98,206211,232689,438900,46.98,53.02,10.58
2016,"OH-13",163274,142580,305854,53.38,46.62,-4.54000000000001,171016,159755,330771,51.7,48.3,1.14
2016,"OH-14",155600,197864,353464,44.02,55.98,14.18,185627,222915,408542,45.44,54.56,13.66
2016,"OH-15",142083,196753,338836,41.93,58.07,18.36,166746,222212,388958,42.87,57.13,18.8
2016,"OH-16",145975,207555,353530,41.29,58.71,19.64,174021,232688,406709,42.79,57.21,18.96
2018,"OH-01",160785,184998,345783,46.5,53.5,9.22,185725,198486,384211,48.34,51.66,7.86000000000001
2018,"OH-02",140964,197879,338843,41.6,58.4,19.02,165789,214527,380316,43.59,56.41,17.36
2018,"OH-03",209683,89607,299290,70.06,29.94,-37.9,230792,93769,324561,71.11,28.89,-37.68
2018,"OH-04",99795,209168,308963,32.3,67.7,37.62,110508,237637,348145,31.74,68.26,41.06
2018,"OH-05",124158,214259,338417,36.69,63.31,28.84,141226,237317,378543,37.31,62.69,29.92
2018,"OH-06",85490,221777,307267,27.82,72.18,46.58,91265,248436,339701,26.87,73.13,50.8
2018,"OH-07",107829,205299,313128,34.44,65.56,33.34,120509,237067,357576,33.7,66.3,37.14
2018,"OH-08",104914,223153,328067,31.98,68.02,38.26,119831,243002,362833,33.03,66.97,38.48
2018,"OH-09",177190,110255,287445,61.64,38.36,-21.06,184430,124619,309049,59.68,40.32,-14.82
2018,"OH-10",153333,178720,332053,46.18,53.82,9.86,172462,188558,361020,47.77,52.23,9
2018,"OH-11",260598,55295,315893,82.5,17.5,-62.78,253034,61185,314219,80.53,19.47,-56.52
2018,"OH-12",162513,205860,368373,44.12,55.88,13.98,206196,232676,438872,46.98,53.02,10.58
2018,"OH-13",163251,142548,305799,53.39,46.61,-4.56,170980,159723,330703,51.7,48.3,1.14
2018,"OH-14",155627,197895,353522,44.02,55.98,14.18,185669,222951,408620,45.44,54.56,13.66
2018,"OH-15",142079,196743,338822,41.93,58.07,18.36,166742,222200,388942,42.87,57.13,18.8
2018,"OH-16",145946,207536,353482,41.29,58.71,19.64,173988,232665,406653,42.79,57.21,18.96
2020,"OH-01",160783,184979,345762,46.5,53.5,9.22,185724,198465,384189,48.34,51.66,7.86000000000001
2020,"OH-02",140987,197958,338945,41.6,58.4,19.02,165826,214620,380446,43.59,56.41,17.36
2020,"OH-03",209682,89605,299287,70.06,29.94,-37.9,230801,93772,324573,71.11,28.89,-37.68
2020,"OH-04",99799,209169,308968,32.3,67.7,37.62,110511,237638,348149,31.74,68.26,41.06
2020,"OH-05",124162,214268,338430,36.69,63.31,28.84,141230,237329,378559,37.31,62.69,29.92
2020,"OH-06",85478,221764,307242,27.82,72.18,46.58,91252,248420,339672,26.86,73.14,50.82
2020,"OH-07",107822,205293,313115,34.44,65.56,33.34,120502,237065,357567,33.7,66.3,37.14
2020,"OH-08",104921,223165,328086,31.98,68.02,38.26,119839,243018,362857,33.03,66.97,38.48
2020,"OH-09",177202,110262,287464,61.64,38.36,-21.06,184443,124626,309069,59.68,40.32,-14.82
2020,"OH-10",153310,178650,331960,46.18,53.82,9.86,172430,188475,360905,47.78,52.22,8.98
2020,"OH-11",260609,55294,315903,82.5,17.5,-62.78,253045,61183,314228,80.53,19.47,-56.52
2020,"OH-12",162530,205882,368412,44.12,55.88,13.98,206204,232697,438901,46.98,53.02,10.58
2020,"OH-13",163260,142549,305809,53.39,46.61,-4.56,170989,159724,330713,51.7,48.3,1.14
2020,"OH-14",155587,197853,353440,44.02,55.98,14.18,185624,222907,408531,45.44,54.56,13.66
2020,"OH-15",142080,196746,338826,41.93,58.07,18.36,166743,222203,388946,42.87,57.13,18.8
2020,"OH-16",145952,207566,353518,41.29,58.71,19.64,174000,232693,406693,42.78,57.22,18.98
2022,"OH-01",188525,173831,362356,52.03,47.97,-1.84,220282,185467,405749,54.29,45.71,-4.04
2022,"OH-02",91121,241549,332670,27.39,72.61,47.44,100797,272381,373178,27.01,72.99,50.52
2022,"OH-03",238856,101818,340674,70.11,29.89,-38,271599,104502,376101,72.21,27.79,-39.88
2022,"OH-04",103532,237269,340801,30.38,69.62,41.46,125753,268751,394504,31.88,68.12,40.78
2022,"OH-05",127173,218074,345247,36.84,63.16,28.54,142159,248476,390635,36.39,63.61,31.76
2022,"OH-06",133898,226300,360198,37.17,62.83,27.88,139282,253739,393021,35.44,64.56,33.66
2022,"OH-07",163095,207509,370604,44.01,55.99,14.2,192632,232291,424923,45.33,54.67,13.88
2022,"OH-08",130326,227060,357386,36.47,63.53,29.28,153240,241554,394794,38.82,61.18,26.9
2022,"OH-09",174105,177585,351690,49.51,50.49,3.2,186030,197399,383429,48.52,51.48,7.50000000000001
2022,"OH-10",166511,189245,355756,46.8,53.2,8.62,185682,199493,385175,48.21,51.79,8.12000000000002
2022,"OH-11",282832,65679,348511,81.15,18.85,-60.08,280493,74075,354568,79.11,20.89,-53.68
2022,"OH-12",115530,218491,334021,34.59,65.41,33.04,131506,251540,383046,34.33,65.67,35.88
2022,"OH-13",182457,174696,357153,51.09,48.91,0.039999999999992,206113,194782,400895,51.41,48.59,1.72000000000001
2022,"OH-14",154511,205992,360503,42.86,57.14,16.5,172859,234605,407464,42.42,57.58,19.7
2022,"OH-15",141692,175907,317599,44.61,55.39,13,170738,195778,366516,46.58,53.42,11.38
2008,"OK-01",102127,193119,295246,34.59,65.41,33.04,126350,204874,331224,38.15,61.85,28.24
2008,"OK-02",60596,192366,252962,23.95,76.05,54.32,62851,214441,277292,22.67,77.33,59.2
2008,"OK-03",58683,208518,267201,21.96,78.04,58.3,68619,224505,293124,23.41,76.59,57.72
2008,"OK-04",87283,206055,293338,29.76,70.24,42.7,107573,221380,328953,32.7,67.3,39.14
2008,"OK-05",111686,149078,260764,42.83,57.17,16.56,138496,155082,293578,47.18,52.82,10.18
2010,"OK-01",102127,193119,295246,34.59,65.41,33.04,126350,204874,331224,38.15,61.85,28.24
2010,"OK-02",60596,192366,252962,23.95,76.05,54.32,62851,214441,277292,22.67,77.33,59.2
2010,"OK-03",58683,208518,267201,21.96,78.04,58.3,68619,224505,293124,23.41,76.59,57.72
2010,"OK-04",87283,206055,293338,29.76,70.24,42.7,107573,221380,328953,32.7,67.3,39.14
2010,"OK-05",111686,149078,260764,42.83,57.17,16.56,138496,155082,293578,47.18,52.82,10.18
2012,"OK-01",101757,191343,293100,34.72,65.28,32.78,125905,202879,328784,38.29,61.71,27.96
2012,"OK-02",62022,198155,260177,23.84,76.16,54.54,64353,221123,285476,22.54,77.46,59.46
2012,"OK-03",61179,216078,277257,22.07,77.93,58.08,72141,232416,304557,23.69,76.31,57.16
2012,"OK-04",83647,194160,277807,30.11,69.89,42,102926,208407,311333,33.06,66.94,38.42
2012,"OK-05",111770,149400,261170,42.8,57.2,16.62,138565,155455,294020,47.13,52.87,10.28
2014,"OK-01",101757,191343,293100,34.72,65.28,32.78,125905,202879,328784,38.29,61.71,27.96
2014,"OK-02",62022,198155,260177,23.84,76.16,54.54,64353,221123,285476,22.54,77.46,59.46
2014,"OK-03",61179,216078,277257,22.07,77.93,58.08,72141,232416,304557,23.69,76.31,57.16
2014,"OK-04",83647,194160,277807,30.11,69.89,42,102926,208407,311333,33.06,66.94,38.42
2014,"OK-05",111770,149400,261170,42.8,57.2,16.62,138565,155455,294020,47.13,52.87,10.28
2016,"OK-01",101757,191343,293100,34.72,65.28,32.78,125905,202879,328784,38.29,61.71,27.96
2016,"OK-02",62022,198155,260177,23.84,76.16,54.54,64353,221123,285476,22.54,77.46,59.46
2016,"OK-03",61179,216078,277257,22.07,77.93,58.08,72141,232416,304557,23.69,76.31,57.16
2016,"OK-04",83647,194160,277807,30.11,69.89,42,102926,208407,311333,33.06,66.94,38.42
2016,"OK-05",111770,149400,261170,42.8,57.2,16.62,138565,155455,294020,47.13,52.87,10.28
2018,"OK-01",101757,191343,293100,34.72,65.28,32.78,125905,202879,328784,38.29,61.71,27.96
2018,"OK-02",62022,198155,260177,23.84,76.16,54.54,64353,221123,285476,22.54,77.46,59.46
2018,"OK-03",61179,216078,277257,22.07,77.93,58.08,72141,232416,304557,23.69,76.31,57.16
2018,"OK-04",83647,194160,277807,30.11,69.89,42,102926,208407,311333,33.06,66.94,38.42
2018,"OK-05",111770,149400,261170,42.8,57.2,16.62,138565,155455,294020,47.13,52.87,10.28
2020,"OK-01",101754,191337,293091,34.72,65.28,32.78,125901,202872,328773,38.29,61.71,27.96
2020,"OK-02",62022,198155,260177,23.84,76.16,54.54,64353,221123,285476,22.54,77.46,59.46
2020,"OK-03",61182,216084,277266,22.07,77.93,58.08,72145,232423,304568,23.69,76.31,57.16
2020,"OK-04",83647,194160,277807,30.11,69.89,42,102926,208407,311333,33.06,66.94,38.42
2020,"OK-05",111770,149400,261170,42.8,57.2,16.62,138565,155455,294020,47.13,52.87,10.28
2022,"OK-01",97917,179801,277718,35.26,64.74,31.7,121817,190026,311843,39.06,60.94,26.42
2022,"OK-02",68861,219005,287866,23.92,76.08,54.38,72020,243707,315727,22.81,77.19,58.92
2022,"OK-03",65826,186515,252341,26.09,73.91,50.04,76878,197051,273929,28.06,71.94,48.42
2022,"OK-04",84871,187086,271957,31.21,68.79,39.8,103890,200233,304123,34.16,65.84,36.22
2022,"OK-05",102900,176728,279628,36.8,63.2,28.62,129286,189264,318550,40.59,59.41,23.36
2008,"OR-01",236121,133570,369691,63.87,36.13,-25.52,317651,162353,480004,66.18,33.82,-27.82
2008,"OR-02",139584,216843,356427,39.16,60.84,23.9,198586,262896,461482,43.03,56.97,18.48
2008,"OR-03",268971,93803,362774,74.14,25.86,-46.06,343770,117302,461072,74.56,25.44,-44.58
2008,"OR-04",172537,177030,349567,49.36,50.64,3.49999999999999,229561,216567,446128,51.46,48.54,1.62000000000001
2008,"OR-05",184893,161158,346051,53.43,46.57,-4.64,250815,199329,450144,55.72,44.28,-6.9
2010,"OR-01",236121,133570,369691,63.87,36.13,-25.52,317651,162353,480004,66.18,33.82,-27.82
2010,"OR-02",139584,216843,356427,39.16,60.84,23.9,198586,262896,461482,43.03,56.97,18.48
2010,"OR-03",268971,93803,362774,74.14,25.86,-46.06,343770,117302,461072,74.56,25.44,-44.58
2010,"OR-04",172537,177030,349567,49.36,50.64,3.49999999999999,229561,216567,446128,51.46,48.54,1.62000000000001
2010,"OR-05",184893,161158,346051,53.43,46.57,-4.64,250815,199329,450144,55.72,44.28,-6.9
2012,"OR-01",219385,132156,351541,62.41,37.59,-22.6,298723,160805,459528,65.01,34.99,-25.48
2012,"OR-02",139059,215710,354769,39.2,60.8,23.82,197922,261601,459523,43.07,56.93,18.4
2012,"OR-03",282560,89739,372299,75.9,24.1,-49.58,356505,111778,468283,76.13,23.87,-47.72
2012,"OR-04",180872,180318,361190,50.08,49.92,2.05999999999999,238619,219851,458470,52.05,47.95,0.440000000000005
2012,"OR-05",180237,164481,344718,52.29,47.71,-2.36000000000001,248621,204415,453036,54.88,45.12,-5.21999999999999
2014,"OR-01",219366,132148,351514,62.41,37.59,-22.6,298696,160794,459490,65.01,34.99,-25.48
2014,"OR-02",139059,215710,354769,39.2,60.8,23.82,197922,261601,459523,43.07,56.93,18.4
2014,"OR-03",282560,89739,372299,75.9,24.1,-49.58,356505,111778,468283,76.13,23.87,-47.72
2014,"OR-04",180872,180318,361190,50.08,49.92,2.05999999999999,238619,219851,458470,52.05,47.95,0.440000000000005
2014,"OR-05",180256,164489,344745,52.29,47.71,-2.36000000000001,248648,204426,453074,54.88,45.12,-5.21999999999999
2016,"OR-01",219385,132156,351541,62.41,37.59,-22.6,298723,160805,459528,65.01,34.99,-25.48
2016,"OR-02",139059,215711,354770,39.2,60.8,23.82,197922,261602,459524,43.07,56.93,18.4
2016,"OR-03",282576,89744,372320,75.9,24.1,-49.58,356504,111777,468281,76.13,23.87,-47.72
2016,"OR-04",180872,180318,361190,50.08,49.92,2.05999999999999,238619,219851,458470,52.05,47.95,0.440000000000005
2016,"OR-05",180221,164476,344697,52.28,47.72,-2.34,248622,204416,453038,54.88,45.12,-5.21999999999999
2018,"OR-01",219385,132156,351541,62.41,37.59,-22.6,298723,160805,459528,65.01,34.99,-25.48
2018,"OR-02",139059,215711,354770,39.2,60.8,23.82,197922,261602,459524,43.07,56.93,18.4
2018,"OR-03",282547,89734,372281,75.9,24.1,-49.58,356488,111773,468261,76.13,23.87,-47.72
2018,"OR-04",180872,180318,361190,50.08,49.92,2.05999999999999,238619,219851,458470,52.05,47.95,0.440000000000005
2018,"OR-05",180250,164486,344736,52.29,47.71,-2.36000000000001,248638,204420,453058,54.88,45.12,-5.21999999999999
2020,"OR-01",219391,132158,351549,62.41,37.59,-22.6,298731,160807,459538,65.01,34.99,-25.48
2020,"OR-02",139059,215711,354770,39.2,60.8,23.82,197922,261602,459524,43.07,56.93,18.4
2020,"OR-03",282535,89730,372265,75.9,24.1,-49.58,356472,111769,468241,76.13,23.87,-47.72
2020,"OR-04",180872,180318,361190,50.08,49.92,2.05999999999999,238619,219851,458470,52.05,47.95,0.440000000000005
2020,"OR-05",180250,164486,344736,52.29,47.71,-2.36000000000001,248638,204420,453058,54.88,45.12,-5.21999999999999
2022,"OR-01",201215,93251,294466,68.33,31.67,-34.44,267346,113716,381062,70.16,29.84,-35.78
2022,"OR-02",102798,194868,297666,34.53,65.47,33.16,140886,236104,376990,37.37,62.63,29.8
2022,"OR-03",220402,76847,297249,74.15,25.85,-46.08,280713,96744,377457,74.37,25.63,-44.2
2022,"OR-04",170292,140430,310722,54.81,45.19,-7.4,223002,168955,391957,56.89,43.11,-9.23999999999999
2022,"OR-05",160607,151079,311686,51.53,48.47,-0.840000000000003,225209,188565,413774,54.43,45.57,-4.31999999999999
2022,"OR-06",146793,125928,272721,53.83,46.17,-5.44,203221,154353,357574,56.83,43.17,-9.12
2008,"PA-01",256649,30442,287091,89.4,10.6,-76.58,258814,40713,299527,86.41,13.59,-68.28
2008,"PA-02",290872,27434,318306,91.38,8.62,-80.54,306308,33575,339883,90.12,9.88,-75.7
2008,"PA-03",105329,170697,276026,38.16,61.84,25.9,123833,193149,316982,39.07,60.93,26.4
2008,"PA-04",140000,193968,333968,41.92,58.08,18.38,176318,219386,395704,44.56,55.44,15.42
2008,"PA-05",87284,186530,273814,31.88,68.12,38.46,100638,214040,314678,31.98,68.02,40.58
2008,"PA-06",197885,154124,352009,56.22,43.78,-10.22,249726,173638,423364,58.99,41.01,-13.44
2008,"PA-07",205966,150936,356902,57.71,42.29,-13.2,253333,163661,416994,60.75,39.25,-16.96
2008,"PA-08",179665,175356,355021,50.61,49.39,1,219453,200287,419740,52.28,47.72,-0.019999999999996
2008,"PA-09",68870,216571,285441,24.13,75.87,53.96,85640,252242,337882,25.35,74.65,53.84
2008,"PA-10",95917,190952,286869,33.44,66.56,35.34,122755,218823,341578,35.94,64.06,32.66
2008,"PA-11",124251,154556,278807,44.57,55.43,13.08,151540,172541,324081,46.76,53.24,11.02
2008,"PA-12",89797,169051,258848,34.69,65.31,32.84,102300,195078,297378,34.4,65.6,35.74
2008,"PA-13",191844,128193,320037,59.94,40.06,-17.66,223392,145840,369232,60.5,39.5,-16.46
2008,"PA-14",200063,79912,279975,71.46,28.54,-40.7,217837,85419,303256,71.83,28.17,-39.12
2008,"PA-15",162189,166191,328380,49.39,50.61,3.44,203718,192591,396309,51.4,48.6,1.74000000000001
2008,"PA-16",141332,176536,317868,44.46,55.54,13.3,173846,203012,376858,46.13,53.87,12.28
2008,"PA-17",119721,186603,306324,39.08,60.92,24.06,148064,209079,357143,41.46,58.54,21.62
2008,"PA-18",144355,197724,342079,42.2,57.8,17.82,181579,219847,401426,45.23,54.77,14.08
2008,"PA-19",124441,215397,339838,36.62,63.38,28.98,161362,245490,406852,39.66,60.34,25.22
2010,"PA-01",256649,30442,287091,89.4,10.6,-76.58,258814,40713,299527,86.41,13.59,-68.28
2010,"PA-02",290872,27434,318306,91.38,8.62,-80.54,306308,33575,339883,90.12,9.88,-75.7
2010,"PA-03",105329,170697,276026,38.16,61.84,25.9,123833,193149,316982,39.07,60.93,26.4
2010,"PA-04",140000,193968,333968,41.92,58.08,18.38,176318,219386,395704,44.56,55.44,15.42
2010,"PA-05",87284,186530,273814,31.88,68.12,38.46,100638,214040,314678,31.98,68.02,40.58
2010,"PA-06",197885,154124,352009,56.22,43.78,-10.22,249726,173638,423364,58.99,41.01,-13.44
2010,"PA-07",205966,150936,356902,57.71,42.29,-13.2,253333,163661,416994,60.75,39.25,-16.96
2010,"PA-08",179665,175356,355021,50.61,49.39,1,219453,200287,419740,52.28,47.72,-0.019999999999996
2010,"PA-09",68870,216571,285441,24.13,75.87,53.96,85640,252242,337882,25.35,74.65,53.84
2010,"PA-10",95917,190952,286869,33.44,66.56,35.34,122755,218823,341578,35.94,64.06,32.66
2010,"PA-11",124251,154556,278807,44.57,55.43,13.08,151540,172541,324081,46.76,53.24,11.02
2010,"PA-12",89797,169051,258848,34.69,65.31,32.84,102300,195078,297378,34.4,65.6,35.74
2010,"PA-13",191844,128193,320037,59.94,40.06,-17.66,223392,145840,369232,60.5,39.5,-16.46
2010,"PA-14",200063,79912,279975,71.46,28.54,-40.7,217837,85419,303256,71.83,28.17,-39.12
2010,"PA-15",162189,166191,328380,49.39,50.61,3.44,203718,192591,396309,51.4,48.6,1.74000000000001
2010,"PA-16",141332,176536,317868,44.46,55.54,13.3,173846,203012,376858,46.13,53.87,12.28
2010,"PA-17",119721,186603,306324,39.08,60.92,24.06,148064,209079,357143,41.46,58.54,21.62
2010,"PA-18",144355,197724,342079,42.2,57.8,17.82,181579,219847,401426,45.23,54.77,14.08
2010,"PA-19",124441,215397,339838,36.62,63.38,28.98,161362,245490,406852,39.66,60.34,25.22
2012,"PA-01",250979,57591,308570,81.34,18.66,-60.46,264636,68613,333249,79.41,20.59,-54.28
2012,"PA-02",334217,28064,362281,92.25,7.75,-82.28,347584,33653,381237,91.17,8.83,-77.8
2012,"PA-03",113554,197917,311471,36.46,63.54,29.3,135195,226670,361865,37.36,62.64,29.82
2012,"PA-04",125737,198522,324259,38.78,61.22,24.66,159865,226838,386703,41.34,58.66,21.86
2012,"PA-05",105147,195779,300926,34.94,65.06,32.34,121709,223237,344946,35.28,64.72,33.98
2012,"PA-06",177628,175322,352950,50.33,49.67,1.56,230838,196661,427499,54,46,-3.45999999999999
2012,"PA-07",190452,181225,371677,51.24,48.76,-0.259999999999998,240063,201324,441387,54.39,45.61,-4.24
2012,"PA-08",185696,186620,372316,49.88,50.12,2.45999999999999,229564,213263,442827,51.84,48.16,0.860000000000007
2012,"PA-09",83266,213442,296708,28.06,71.94,46.1,98730,247891,346621,28.48,71.52,47.58
2012,"PA-10",93391,204763,298154,31.32,68.68,39.58,119299,237703,357002,33.42,66.58,37.7
2012,"PA-11",115702,191814,307516,37.62,62.38,26.98,145090,214502,359592,40.35,59.65,23.84
2012,"PA-12",137600,213082,350682,39.24,60.76,23.74,169723,240021,409744,41.42,58.58,21.7
2012,"PA-13",217340,105575,322915,67.31,32.69,-32.4,244326,122578,366904,66.59,33.41,-28.64
2012,"PA-14",231948,107163,339111,68.4,31.6,-34.58,256393,114511,370904,69.13,30.87,-33.72
2012,"PA-15",148049,173537,321586,46.04,53.96,10.14,184700,198394,383094,48.21,51.79,8.12000000000002
2012,"PA-16",140312,161913,302225,46.43,53.57,9.35999999999999,170264,186323,356587,47.75,52.25,9.04000000000001
2012,"PA-17",132560,163616,296176,44.76,55.24,12.7,163482,183668,347150,47.09,52.91,10.36
2012,"PA-18",142855,215235,358090,39.89,60.11,22.44,178998,242569,421567,42.46,57.54,19.62
2014,"PA-01",250979,57591,308570,81.34,18.66,-60.46,264636,68613,333249,79.41,20.59,-54.28
2014,"PA-02",334217,28064,362281,92.25,7.75,-82.28,347584,33653,381237,91.17,8.83,-77.8
2014,"PA-03",113554,197917,311471,36.46,63.54,29.3,135195,226670,361865,37.36,62.64,29.82
2014,"PA-04",125737,198522,324259,38.78,61.22,24.66,159865,226838,386703,41.34,58.66,21.86
2014,"PA-05",105147,195779,300926,34.94,65.06,32.34,121709,223237,344946,35.28,64.72,33.98
2014,"PA-06",177628,175322,352950,50.33,49.67,1.56,230838,196661,427499,54,46,-3.45999999999999
2014,"PA-07",190451,181226,371677,51.24,48.76,-0.259999999999998,240062,201325,441387,54.39,45.61,-4.24
2014,"PA-08",185696,186620,372316,49.88,50.12,2.45999999999999,229564,213263,442827,51.84,48.16,0.860000000000007
2014,"PA-09",83266,213442,296708,28.06,71.94,46.1,98730,247891,346621,28.48,71.52,47.58
2014,"PA-10",93391,204763,298154,31.32,68.68,39.58,119299,237703,357002,33.42,66.58,37.7
2014,"PA-11",115681,191792,307473,37.62,62.38,26.98,145065,214478,359543,40.35,59.65,23.84
2014,"PA-12",137600,213082,350682,39.24,60.76,23.74,169723,240021,409744,41.42,58.58,21.7
2014,"PA-13",217341,105574,322915,67.31,32.69,-32.4,244327,122577,366904,66.59,33.41,-28.64
2014,"PA-14",231948,107163,339111,68.4,31.6,-34.58,256393,114511,370904,69.13,30.87,-33.72
2014,"PA-15",148070,173559,321629,46.04,53.96,10.14,184725,198418,383143,48.21,51.79,8.12000000000002
2014,"PA-16",140312,161913,302225,46.43,53.57,9.35999999999999,170264,186323,356587,47.75,52.25,9.04000000000001
2014,"PA-17",132560,163616,296176,44.76,55.24,12.7,163482,183668,347150,47.09,52.91,10.36
2014,"PA-18",142855,215235,358090,39.89,60.11,22.44,178998,242569,421567,42.46,57.54,19.62
2016,"PA-01",250991,57592,308583,81.34,18.66,-60.46,264649,68615,333264,79.41,20.59,-54.28
2016,"PA-02",334205,28063,362268,92.25,7.75,-82.28,347571,33651,381222,91.17,8.83,-77.8
2016,"PA-03",113554,197917,311471,36.46,63.54,29.3,135195,226670,361865,37.36,62.64,29.82
2016,"PA-04",125737,198522,324259,38.78,61.22,24.66,159865,226838,386703,41.34,58.66,21.86
2016,"PA-05",105147,195779,300926,34.94,65.06,32.34,121709,223237,344946,35.28,64.72,33.98
2016,"PA-06",177649,175344,352993,50.33,49.67,1.56,230867,196686,427553,54,46,-3.45999999999999
2016,"PA-07",190461,181237,371698,51.24,48.76,-0.259999999999998,240072,201336,441408,54.39,45.61,-4.24
2016,"PA-08",185697,186620,372317,49.88,50.12,2.45999999999999,229564,213263,442827,51.84,48.16,0.860000000000007
2016,"PA-09",83266,213442,296708,28.06,71.94,46.1,98730,247891,346621,28.48,71.52,47.58
2016,"PA-10",93391,204763,298154,31.32,68.68,39.58,119299,237703,357002,33.42,66.58,37.7
2016,"PA-11",115681,191792,307473,37.62,62.38,26.98,145065,214478,359543,40.35,59.65,23.84
2016,"PA-12",137600,213082,350682,39.24,60.76,23.74,169723,240021,409744,41.42,58.58,21.7
2016,"PA-13",217334,105569,322903,67.31,32.69,-32.4,244320,122572,366892,66.59,33.41,-28.64
2016,"PA-14",231948,107163,339111,68.4,31.6,-34.58,256393,114511,370904,69.13,30.87,-33.72
2016,"PA-15",148078,173574,321652,46.04,53.96,10.14,184736,198435,383171,48.21,51.79,8.12000000000002
2016,"PA-16",140287,161885,302172,46.43,53.57,9.35999999999999,170232,186292,356524,47.75,52.25,9.04000000000001
2016,"PA-17",132556,163604,296160,44.76,55.24,12.7,163476,183654,347130,47.09,52.91,10.36
2016,"PA-18",142855,215235,358090,39.89,60.11,22.44,178998,242569,421567,42.46,57.54,19.62
2018,"PA-01",189261,181635,370896,51.03,48.97,0.159999999999997,233363,207358,440721,52.95,47.05,-1.35999999999999
2018,"PA-02",207253,70704,277957,74.56,25.44,-46.9,207796,86171,293967,70.69,29.31,-36.84
2018,"PA-03",339424,26175,365599,92.84,7.16,-83.46,357600,31695,389295,91.86,8.14,-79.18
2018,"PA-04",221338,147280,368618,60.05,39.95,-17.88,276561,168239,444800,62.18,37.82,-19.82
2018,"PA-05",230144,126381,356525,64.55,35.45,-26.88,263724,137748,401472,65.69,34.31,-26.84
2018,"PA-06",185794,152957,338751,54.85,45.15,-7.48,231738,170307,402045,57.64,42.36,-10.74
2018,"PA-07",160258,156703,316961,50.56,49.44,1.09999999999999,199283,180774,380057,52.44,47.56,-0.339999999999989
2018,"PA-08",135598,165072,300670,45.1,54.9,12.02,168534,184210,352744,47.78,52.22,8.98
2018,"PA-09",97955,205434,303389,32.29,67.71,37.64,122858,232538,355396,34.57,65.43,35.4
2018,"PA-10",149941,180756,330697,45.34,54.66,11.54,189612,201105,390717,48.53,51.47,7.48000000000001
2018,"PA-11",115297,201416,316713,36.4,63.6,29.42,148411,232890,381301,38.92,61.08,26.7
2018,"PA-12",91148,202947,294095,30.99,69.01,40.24,107770,232348,340118,31.69,68.31,41.16
2018,"PA-13",81712,228029,309741,26.38,73.62,49.46,100809,264612,365421,27.59,72.41,49.36
2018,"PA-14",112824,209381,322205,35.02,64.98,32.18,135856,240317,376173,36.12,63.88,32.3
2018,"PA-15",81981,215653,297634,27.54,72.46,47.14,96955,250697,347652,27.89,72.11,48.76
2018,"PA-16",122708,187362,310070,39.57,60.43,23.08,145408,213156,358564,40.55,59.45,23.44
2018,"PA-17",178494,188052,366546,48.7,51.3,4.82000000000001,221506,209597,431103,51.38,48.62,1.78000000000001
2018,"PA-18",225307,125246,350553,64.27,35.73,-26.32,252681,134660,387341,65.23,34.77,-25.92
2020,"PA-01",189261,181635,370896,51.03,48.97,0.159999999999997,233363,207358,440721,52.95,47.05,-1.35999999999999
2020,"PA-02",207253,70704,277957,74.56,25.44,-46.9,207796,86171,293967,70.69,29.31,-36.84
2020,"PA-03",339403,26171,365574,92.84,7.16,-83.46,357576,31691,389267,91.86,8.14,-79.18
2020,"PA-04",221338,147280,368618,60.05,39.95,-17.88,276561,168239,444800,62.18,37.82,-19.82
2020,"PA-05",230164,126385,356549,64.55,35.45,-26.88,263748,137752,401500,65.69,34.31,-26.84
2020,"PA-06",185790,152950,338740,54.85,45.15,-7.48,231733,170300,402033,57.64,42.36,-10.74
2020,"PA-07",160258,156703,316961,50.56,49.44,1.09999999999999,199283,180774,380057,52.44,47.56,-0.339999999999989
2020,"PA-08",135633,165126,300759,45.1,54.9,12.02,168579,184279,352858,47.78,52.22,8.98
2020,"PA-09",97931,205399,303330,32.29,67.71,37.64,122826,232489,355315,34.57,65.43,35.4
2020,"PA-10",149905,180733,330638,45.34,54.66,11.54,189546,201080,390626,48.52,51.48,7.50000000000001
2020,"PA-11",115301,201423,316724,36.4,63.6,29.42,148416,232899,381315,38.92,61.08,26.7
2020,"PA-12",91147,202947,294094,30.99,69.01,40.24,107771,232350,340121,31.69,68.31,41.16
2020,"PA-13",81738,228029,309767,26.39,73.61,49.44,100861,264610,365471,27.6,72.4,49.34
2020,"PA-14",112818,209359,322177,35.02,64.98,32.18,135836,240279,376115,36.12,63.88,32.3
2020,"PA-15",81989,215675,297664,27.54,72.46,47.14,96966,250722,347688,27.89,72.11,48.76
2020,"PA-16",122709,187366,310075,39.57,60.43,23.08,145409,213160,358569,40.55,59.45,23.44
2020,"PA-17",178479,188026,366505,48.7,51.3,4.82000000000001,221490,209564,431054,51.38,48.62,1.78000000000001
2020,"PA-18",225325,125286,350611,64.27,35.73,-26.32,252715,134724,387439,65.23,34.77,-25.92
2022,"PA-01",195169,192326,387495,50.37,49.63,1.48,241505,219870,461375,52.34,47.66,-0.139999999999986
2022,"PA-02",218989,72243,291232,75.19,24.81,-48.16,221341,88108,309449,71.53,28.47,-38.52
2022,"PA-03",340345,30374,370719,91.81,8.19,-81.4,357631,36695,394326,90.69,9.31,-76.84
2022,"PA-04",215678,161300,376978,57.21,42.79,-12.2,269374,183087,452461,59.54,40.46,-14.54
2022,"PA-05",238709,128743,367452,64.96,35.04,-27.7,276188,140513,416701,66.28,33.72,-28.02
2022,"PA-06",188180,156163,344343,54.65,45.35,-7.08,234902,173844,408746,57.47,42.53,-10.4
2022,"PA-07",158470,168308,326778,48.49,51.51,5.23999999999999,197368,195061,392429,50.29,49.71,3.96000000000001
2022,"PA-08",147370,174051,321421,45.85,54.15,10.52,182941,193875,376816,48.55,51.45,7.44
2022,"PA-09",95417,229050,324467,29.41,70.59,43.4,119782,260949,380731,31.46,68.54,41.62
2022,"PA-10",149156,183686,332842,44.81,55.19,12.6,188662,205200,393862,47.9,52.1,8.74000000000001
2022,"PA-11",119034,205994,325028,36.62,63.38,28.98,153274,237591,390865,39.21,60.79,26.12
2022,"PA-12",225113,156148,381261,59.04,40.96,-15.86,255266,169584,424850,60.08,39.92,-15.62
2022,"PA-13",87353,247619,334972,26.08,73.92,50.06,107208,288169,395377,27.12,72.88,50.3
2022,"PA-14",117385,233732,351117,33.43,66.57,35.36,138911,268757,407668,34.07,65.93,36.4
2022,"PA-15",103018,228838,331856,31.04,68.96,40.14,119654,263303,382957,31.24,68.76,42.06
2022,"PA-16",132840,212607,345447,38.45,61.55,25.32,158735,242671,401406,39.54,60.46,25.46
2022,"PA-17",194214,190012,384226,50.55,49.45,1.12,237729,211162,448891,52.96,47.04,-1.37999999999999
2008,"RI-01",126917,79962,206879,61.35,38.65,-20.48,153382,87768,241150,63.6,36.4,-22.66
2008,"RI-02",125497,100509,226006,55.53,44.47,-8.84,153973,112074,266047,57.87,42.13,-11.2
2010,"RI-01",126917,79962,206879,61.35,38.65,-20.48,153382,87768,241150,63.6,36.4,-22.66
2010,"RI-02",125497,100509,226006,55.53,44.47,-8.84,153973,112074,266047,57.87,42.13,-11.2
2012,"RI-01",130617,75464,206081,63.38,36.62,-24.54,154348,83550,237898,64.88,35.12,-25.22
2012,"RI-02",121797,105007,226804,53.7,46.3,-5.18,153007,116292,269299,56.82,43.18,-9.1
2014,"RI-01",130617,75464,206081,63.38,36.62,-24.54,154348,83550,237898,64.88,35.12,-25.22
2014,"RI-02",121797,105007,226804,53.7,46.3,-5.18,153007,116292,269299,56.82,43.18,-9.1
2016,"RI-01",130728,75536,206264,63.38,36.62,-24.54,154479,83630,238109,64.88,35.12,-25.22
2016,"RI-02",121797,105007,226804,53.7,46.3,-5.18,153007,116292,269299,56.82,43.18,-9.1
2018,"RI-01",130697,75512,206209,63.38,36.62,-24.54,154438,83608,238046,64.88,35.12,-25.22
2018,"RI-02",121828,105031,226859,53.7,46.3,-5.18,153048,116314,269362,56.82,43.18,-9.1
2020,"RI-01",130686,75511,206197,63.38,36.62,-24.54,154430,83606,238036,64.88,35.12,-25.22
2020,"RI-02",121839,105032,226871,53.7,46.3,-5.18,153056,116316,269372,56.82,43.18,-9.1
2022,"RI-01",129221,75147,204368,63.23,36.77,-24.24,153014,83234,236248,64.77,35.23,-25
2022,"RI-02",123304,105396,228700,53.92,46.08,-5.62,154472,116688,271160,56.97,43.03,-9.39999999999999
2008,"SC-01",160609,236915,397524,40.4,59.6,21.42,234434,302292,536726,43.68,56.32,17.18
2008,"SC-02",167774,197529,365303,45.93,54.07,10.36,217850,230950,448800,48.54,51.46,7.46
2008,"SC-03",92384,207677,300061,30.79,69.21,40.64,113518,244755,358273,31.68,68.32,41.18
2008,"SC-04",119767,212611,332378,36.03,63.97,30.16,161682,253395,415077,38.95,61.05,26.64
2008,"SC-05",140184,192567,332751,42.13,57.87,17.96,173504,231783,405287,42.81,57.19,18.92
2008,"SC-06",174656,108090,282746,61.77,38.23,-21.32,190546,121919,312465,60.98,39.02,-17.42
2010,"SC-01",160609,236915,397524,40.4,59.6,21.42,234434,302292,536726,43.68,56.32,17.18
2010,"SC-02",167774,197529,365303,45.93,54.07,10.36,217850,230950,448800,48.54,51.46,7.46
2010,"SC-03",92384,207677,300061,30.79,69.21,40.64,113518,244755,358273,31.68,68.32,41.18
2010,"SC-04",119767,212611,332378,36.03,63.97,30.16,161682,253395,415077,38.95,61.05,26.64
2010,"SC-05",140184,192567,332751,42.13,57.87,17.96,173504,231783,405287,42.81,57.19,18.92
2010,"SC-06",174656,108090,282746,61.77,38.23,-21.32,190546,121919,312465,60.98,39.02,-17.42
2012,"SC-01",132575,174798,307373,43.13,56.87,15.96,196166,221444,417610,46.97,53.03,10.6
2012,"SC-02",119684,175460,295144,40.55,59.45,21.12,158178,199741,357919,44.19,55.81,16.16
2012,"SC-03",82921,190792,273713,30.29,69.71,41.64,102910,228489,331399,31.05,68.95,42.44
2012,"SC-04",103723,181166,284889,36.41,63.59,29.4,140461,214458,354919,39.58,60.42,25.38
2012,"SC-05",118920,175712,294632,40.36,59.64,21.5,151068,212452,363520,41.56,58.44,21.42
2012,"SC-06",180904,84400,265304,68.19,31.81,-34.16,195984,93799,289783,67.63,32.37,-30.72
2012,"SC-07",116645,173062,289707,40.26,59.74,21.7,146768,214711,361479,40.6,59.4,23.34
2014,"SC-01",132575,174798,307373,43.13,56.87,15.96,196166,221444,417610,46.97,53.03,10.6
2014,"SC-02",119678,175464,295142,40.55,59.45,21.12,158170,199746,357916,44.19,55.81,16.16
2014,"SC-03",82921,190792,273713,30.29,69.71,41.64,102910,228489,331399,31.05,68.95,42.44
2014,"SC-04",103723,181166,284889,36.41,63.59,29.4,140461,214458,354919,39.58,60.42,25.38
2014,"SC-05",118917,175706,294623,40.36,59.64,21.5,151065,212445,363510,41.56,58.44,21.42
2014,"SC-06",180913,84402,265315,68.19,31.81,-34.16,195995,93801,289796,67.63,32.37,-30.72
2014,"SC-07",116645,173062,289707,40.26,59.74,21.7,146768,214711,361479,40.6,59.4,23.34
2016,"SC-01",132575,174798,307373,43.13,56.87,15.96,196166,221444,417610,46.97,53.03,10.6
2016,"SC-02",119678,175464,295142,40.55,59.45,21.12,158170,199746,357916,44.19,55.81,16.16
2016,"SC-03",82912,190781,273693,30.29,69.71,41.64,102895,228473,331368,31.05,68.95,42.44
2016,"SC-04",103732,181177,284909,36.41,63.59,29.4,140476,214474,354950,39.58,60.42,25.38
2016,"SC-05",118917,175706,294623,40.36,59.64,21.5,151065,212445,363510,41.56,58.44,21.42
2016,"SC-06",180913,84402,265315,68.19,31.81,-34.16,195995,93801,289796,67.63,32.37,-30.72
2016,"SC-07",116645,173062,289707,40.26,59.74,21.7,146768,214711,361479,40.6,59.4,23.34
2018,"SC-01",132599,174811,307410,43.13,56.87,15.96,196183,221487,417670,46.97,53.03,10.6
2018,"SC-02",119705,175437,295142,40.56,59.44,21.1,158186,199716,357902,44.2,55.8,16.14
2018,"SC-03",82925,190812,273737,30.29,69.71,41.64,102915,228508,331423,31.05,68.95,42.44
2018,"SC-04",103727,181152,284879,36.41,63.59,29.4,140469,214446,354915,39.58,60.42,25.38
2018,"SC-05",118916,175717,294633,40.36,59.64,21.5,151069,212464,363533,41.56,58.44,21.42
2018,"SC-06",180832,84376,265208,68.18,31.82,-34.14,195926,93744,289670,67.64,32.36,-30.74
2018,"SC-07",116642,173054,289696,40.26,59.74,21.7,146764,214701,361465,40.6,59.4,23.34
2020,"SC-01",132599,174811,307410,43.13,56.87,15.96,196183,221487,417670,46.97,53.03,10.6
2020,"SC-02",119704,175436,295140,40.56,59.44,21.1,158184,199715,357899,44.2,55.8,16.14
2020,"SC-03",82926,190812,273738,30.29,69.71,41.64,102918,228515,331433,31.05,68.95,42.44
2020,"SC-04",103713,181113,284826,36.41,63.59,29.4,140452,214400,354852,39.58,60.42,25.38
2020,"SC-05",118927,175749,294676,40.36,59.64,21.5,151080,212496,363576,41.55,58.45,21.44
2020,"SC-06",180835,84384,265219,68.18,31.82,-34.14,195931,93752,289683,67.64,32.36,-30.74
2020,"SC-07",116642,173054,289696,40.26,59.74,21.7,146764,214701,361465,40.6,59.4,23.34
2022,"SC-01",117695,160918,278613,42.24,57.76,17.74,171001,203545,374546,45.66,54.34,13.22
2022,"SC-02",121615,175213,296828,40.97,59.03,20.28,160921,199764,360685,44.62,55.38,15.3
2022,"SC-03",86422,198612,285034,30.32,69.68,41.58,106473,236990,343463,31,69,42.54
2022,"SC-04",102317,171351,273668,37.39,62.61,27.44,138178,202542,340720,40.55,59.45,23.44
2022,"SC-05",114581,175656,290237,39.48,60.52,23.26,147258,213496,360754,40.82,59.18,22.9
2022,"SC-06",195460,99549,295009,66.26,33.74,-30.3,220420,113083,333503,66.09,33.91,-27.64
2022,"SC-07",117257,174059,291316,40.25,59.75,21.72,147261,215646,362907,40.58,59.42,23.38
2008,"SD-01",117466,227731,345197,34.03,65.97,34.16,150471,261043,411514,36.57,63.43,31.4
2010,"SD-01",117466,227731,345197,34.03,65.97,34.16,150471,261043,411514,36.57,63.43,31.4
2012,"SD-01",117466,227731,345197,34.03,65.97,34.16,150471,261043,411514,36.57,63.43,31.4
2014,"SD-01",117466,227731,345197,34.03,65.97,34.16,150471,261043,411514,36.57,63.43,31.4
2016,"SD-01",117466,227731,345197,34.03,65.97,34.16,150471,261043,411514,36.57,63.43,31.4
2018,"SD-01",117466,227731,345197,34.03,65.97,34.16,150471,261043,411514,36.57,63.43,31.4
2020,"SD-01",117466,227731,345197,34.03,65.97,34.16,150471,261043,411514,36.57,63.43,31.4
2022,"SD-01",117466,227731,345197,34.03,65.97,34.16,150471,261043,411514,36.57,63.43,31.4
2008,"TN-01",50797,196090,246887,20.57,79.43,61.08,68257,233088,301345,22.65,77.35,59.24
2008,"TN-02",88265,197327,285592,30.91,69.09,40.4,126936,239328,366264,34.66,65.34,35.22
2008,"TN-03",83361,178787,262148,31.8,68.2,38.62,111937,215898,327835,34.14,65.86,36.26
2008,"TN-04",60025,198702,258727,23.2,76.8,55.82,73355,248959,322314,22.76,77.24,59.02
2008,"TN-05",155005,115194,270199,57.37,42.63,-12.52,211568,140929,352497,60.02,39.98,-15.5
2008,"TN-06",87660,215122,302782,28.95,71.05,44.32,127681,273779,401460,31.8,68.2,40.94
2008,"TN-07",116603,227515,344118,33.88,66.12,34.46,166086,271971,438057,37.91,62.09,28.72
2008,"TN-08",75006,152795,227801,32.93,67.07,36.36,85094,181442,266536,31.93,68.07,40.68
2008,"TN-09",153974,41393,195367,78.81,21.19,-55.4,172797,47081,219878,78.59,21.41,-52.64
2010,"TN-01",50797,196090,246887,20.57,79.43,61.08,68257,233088,301345,22.65,77.35,59.24
2010,"TN-02",88265,197327,285592,30.91,69.09,40.4,126936,239328,366264,34.66,65.34,35.22
2010,"TN-03",83361,178787,262148,31.8,68.2,38.62,111937,215898,327835,34.14,65.86,36.26
2010,"TN-04",60025,198702,258727,23.2,76.8,55.82,73355,248959,322314,22.76,77.24,59.02
2010,"TN-05",155005,115194,270199,57.37,42.63,-12.52,211568,140929,352497,60.02,39.98,-15.5
2010,"TN-06",87660,215122,302782,28.95,71.05,44.32,127681,273779,401460,31.8,68.2,40.94
2010,"TN-07",116603,227515,344118,33.88,66.12,34.46,166086,271971,438057,37.91,62.09,28.72
2010,"TN-08",75006,152795,227801,32.93,67.07,36.36,85094,181442,266536,31.93,68.07,40.68
2010,"TN-09",153974,41393,195367,78.81,21.19,-55.4,172797,47081,219878,78.59,21.41,-52.64
2012,"TN-01",52212,203500,255712,20.42,79.58,61.38,70426,242482,312908,22.51,77.49,59.52
2012,"TN-02",86242,189122,275364,31.32,68.68,39.58,124265,229191,353456,35.16,64.84,34.22
2012,"TN-03",83706,181870,265576,31.52,68.48,39.18,110695,220346,331041,33.44,66.56,37.66
2012,"TN-04",75841,188656,264497,28.67,71.33,44.88,108719,238349,347068,31.32,68.68,41.9
2012,"TN-05",156734,106258,262992,59.6,40.4,-16.98,210297,128620,338917,62.05,37.95,-19.56
2012,"TN-06",70407,215921,286328,24.59,75.41,53.04,96217,273163,369380,26.05,73.95,52.44
2012,"TN-07",82102,196815,278917,29.44,70.56,43.34,114930,245790,360720,31.86,68.14,40.82
2012,"TN-08",90419,196351,286770,31.53,68.47,39.16,113635,225177,338812,33.54,66.46,37.46
2012,"TN-09",173032,44432,217464,79.57,20.43,-56.92,194527,49357,243884,79.76,20.24,-54.98
2014,"TN-01",52212,203500,255712,20.42,79.58,61.38,70426,242482,312908,22.51,77.49,59.52
2014,"TN-02",86242,189122,275364,31.32,68.68,39.58,124265,229191,353456,35.16,64.84,34.22
2014,"TN-03",83706,181870,265576,31.52,68.48,39.18,110695,220346,331041,33.44,66.56,37.66
2014,"TN-04",75841,188656,264497,28.67,71.33,44.88,108719,238349,347068,31.32,68.68,41.9
2014,"TN-05",156727,106243,262970,59.6,40.4,-16.98,210285,128600,338885,62.05,37.95,-19.56
2014,"TN-06",70414,215936,286350,24.59,75.41,53.04,96229,273183,369412,26.05,73.95,52.44
2014,"TN-07",82102,196815,278917,29.44,70.56,43.34,114930,245790,360720,31.86,68.14,40.82
2014,"TN-08",90419,196351,286770,31.53,68.47,39.16,113635,225177,338812,33.54,66.46,37.46
2014,"TN-09",173032,44432,217464,79.57,20.43,-56.92,194527,49357,243884,79.76,20.24,-54.98
2016,"TN-01",52212,203500,255712,20.42,79.58,61.38,70426,242482,312908,22.51,77.49,59.52
2016,"TN-02",86242,189122,275364,31.32,68.68,39.58,124265,229191,353456,35.16,64.84,34.22
2016,"TN-03",83706,181870,265576,31.52,68.48,39.18,110695,220346,331041,33.44,66.56,37.66
2016,"TN-04",75841,188656,264497,28.67,71.33,44.88,108719,238349,347068,31.32,68.68,41.9
2016,"TN-05",156727,106243,262970,59.6,40.4,-16.98,210285,128600,338885,62.05,37.95,-19.56
2016,"TN-06",70414,215936,286350,24.59,75.41,53.04,96229,273183,369412,26.05,73.95,52.44
2016,"TN-07",82102,196815,278917,29.44,70.56,43.34,114930,245790,360720,31.86,68.14,40.82
2016,"TN-08",90419,196351,286770,31.53,68.47,39.16,113635,225177,338812,33.54,66.46,37.46
2016,"TN-09",173032,44432,217464,79.57,20.43,-56.92,194527,49357,243884,79.76,20.24,-54.98
2018,"TN-01",52212,203500,255712,20.42,79.58,61.38,70426,242482,312908,22.51,77.49,59.52
2018,"TN-02",86242,189122,275364,31.32,68.68,39.58,124265,229191,353456,35.16,64.84,34.22
2018,"TN-03",83699,181848,265547,31.52,68.48,39.18,110686,220319,331005,33.44,66.56,37.66
2018,"TN-04",75848,188678,264526,28.67,71.33,44.88,108728,238376,347104,31.32,68.68,41.9
2018,"TN-05",156717,106231,262948,59.6,40.4,-16.98,210272,128587,338859,62.05,37.95,-19.56
2018,"TN-06",70414,215936,286350,24.59,75.41,53.04,96229,273183,369412,26.05,73.95,52.44
2018,"TN-07",82112,196827,278939,29.44,70.56,43.34,114943,245803,360746,31.86,68.14,40.82
2018,"TN-08",90405,196338,286743,31.53,68.47,39.16,113620,225163,338783,33.54,66.46,37.46
2018,"TN-09",173046,44445,217491,79.56,20.44,-56.9,194542,49371,243913,79.76,20.24,-54.98
2020,"TN-01",52212,203500,255712,20.42,79.58,61.38,70426,242482,312908,22.51,77.49,59.52
2020,"TN-02",86242,189122,275364,31.32,68.68,39.58,124265,229191,353456,35.16,64.84,34.22
2020,"TN-03",83698,181840,265538,31.52,68.48,39.18,110684,220309,330993,33.44,66.56,37.66
2020,"TN-04",75849,188686,264535,28.67,71.33,44.88,108730,238386,347116,31.32,68.68,41.9
2020,"TN-05",156724,106246,262970,59.6,40.4,-16.98,210284,128607,338891,62.05,37.95,-19.56
2020,"TN-06",70407,215921,286328,24.59,75.41,53.04,96217,273163,369380,26.05,73.95,52.44
2020,"TN-07",82112,196827,278939,29.44,70.56,43.34,114943,245803,360746,31.86,68.14,40.82
2020,"TN-08",90381,196236,286617,31.53,68.47,39.16,113589,225029,338618,33.54,66.46,37.46
2020,"TN-09",172882,44394,217276,79.57,20.43,-56.92,194363,49309,243672,79.76,20.24,-54.98
2022,"TN-01",55088,214859,269947,20.41,79.59,61.4,74205,256818,331023,22.42,77.58,59.7
2022,"TN-02",85199,186701,271900,31.33,68.67,39.56,122627,226531,349158,35.12,64.88,34.3
2022,"TN-03",86567,188466,275033,31.48,68.52,39.26,115388,226507,341895,33.75,66.25,37.04
2022,"TN-04",70087,175920,246007,28.49,71.51,45.24,98049,220550,318599,30.78,69.22,42.98
2022,"TN-05",110220,160091,270311,40.78,59.22,20.66,156424,198155,354579,44.12,55.88,16.3
2022,"TN-06",89889,178169,268058,33.53,66.47,35.16,121956,223610,345566,35.29,64.71,33.96
2022,"TN-07",99007,142547,241554,40.99,59.01,20.24,135015,183960,318975,42.33,57.67,19.88
2022,"TN-08",91007,212521,303528,29.98,70.02,42.26,111135,244992,356127,31.21,68.79,42.12
2022,"TN-09",183443,63496,246939,74.29,25.71,-46.36,208704,71156,279860,74.57,25.43,-44.6
2008,"TX-01",68267,197121,265388,25.72,74.28,50.78,85263,227662,312925,27.25,72.75,50.04
2008,"TX-02",119344,162074,281418,42.41,57.59,17.4,156653,189430,346083,45.26,54.74,14.02
2008,"TX-03",148558,162754,311312,47.72,52.28,6.78,221308,191332,412640,53.63,46.37,-2.72
2008,"TX-04",89206,255485,344691,25.88,74.12,50.46,140279,322906,463185,30.29,69.71,43.96
2008,"TX-05",87072,165493,252565,34.48,65.52,33.26,118142,193860,312002,37.87,62.13,28.8
2008,"TX-06",116663,174670,291333,40.04,59.96,22.14,167239,204955,372194,44.93,55.07,14.68
2008,"TX-07",152141,147354,299495,50.8,49.2,0.620000000000005,205130,172397,377527,54.34,45.66,-4.13999999999999
2008,"TX-08",73292,262809,336101,21.81,78.19,58.6,107360,328809,436169,24.61,75.39,55.32
2008,"TX-09",143254,30502,173756,82.45,17.55,-62.68,167262,50669,217931,76.75,23.25,-48.96
2008,"TX-10",191168,207543,398711,47.95,52.05,6.32,289292,269887,559179,51.74,48.26,1.06000000000001
2008,"TX-11",49972,190287,240259,20.8,79.2,60.62,61513,231738,293251,20.98,79.02,62.58
2008,"TX-12",102983,191220,294203,35,65,32.22,153175,242954,396129,38.67,61.33,27.2
2008,"TX-13",38586,180559,219145,17.61,82.39,67,51398,206638,258036,19.92,80.08,64.7
2008,"TX-14",96689,209034,305723,31.63,68.37,38.96,134490,261008,395498,34.01,65.99,36.52
2008,"TX-15",116461,78345,194806,59.78,40.22,-17.34,127215,118216,245431,51.83,48.17,0.88000000000001
2008,"TX-16",140873,53332,194205,72.54,27.46,-42.86,170451,80302,250753,67.98,32.02,-31.42
2008,"TX-17",75442,190476,265918,28.37,71.63,45.48,106435,234716,341151,31.2,68.8,42.14
2008,"TX-18",159385,41154,200539,79.48,20.52,-56.74,193704,60781,254485,76.12,23.88,-47.7
2008,"TX-19",53689,169769,223458,24.03,75.97,54.16,71617,200758,272375,26.29,73.71,51.96
2008,"TX-20",126312,54936,181248,69.69,30.31,-37.16,163770,73157,236927,69.12,30.88,-33.7
2008,"TX-21",170525,225145,395670,43.1,56.9,16.02,246075,279698,525773,46.8,53.2,10.94
2008,"TX-22",167902,187691,355593,47.22,52.78,7.78,239121,239026,478147,50.01,49.99,4.52000000000001
2008,"TX-23",151384,131452,282836,53.52,46.48,-4.82000000000001,204864,182379,387243,52.9,47.1,-1.26000000000001
2008,"TX-24",144160,139418,283578,50.84,49.16,0.539999999999999,206216,161549,367765,56.07,43.93,-7.59999999999999
2008,"TX-25",203338,124460,327798,62.03,37.97,-21.84,297136,160558,457694,64.92,35.08,-25.3
2008,"TX-26",147855,218217,366072,40.39,59.61,21.44,231092,276869,507961,45.49,54.51,13.56
2008,"TX-27",107860,84616,192476,56.04,43.96,-9.86,122868,118294,241162,50.95,49.05,2.64000000000001
2008,"TX-28",127287,96504,223791,56.88,43.12,-11.54,140546,154047,294593,47.71,52.29,9.12000000000001
2008,"TX-29",87804,32999,120803,72.68,27.32,-43.14,97315,50377,147692,65.89,34.11,-27.24
2008,"TX-30",171710,33993,205703,83.47,16.53,-64.72,210685,46031,256716,82.07,17.93,-59.6
2008,"TX-31",134247,193853,328100,40.92,59.08,20.38,216967,254162,471129,46.05,53.95,12.44
2008,"TX-32",114436,91592,206028,55.54,44.46,-8.86,154703,105406,260109,59.48,40.52,-14.42
2010,"TX-01",68267,197121,265388,25.72,74.28,50.78,85263,227662,312925,27.25,72.75,50.04
2010,"TX-02",119344,162074,281418,42.41,57.59,17.4,156653,189430,346083,45.26,54.74,14.02
2010,"TX-03",148558,162754,311312,47.72,52.28,6.78,221308,191332,412640,53.63,46.37,-2.72
2010,"TX-04",89206,255485,344691,25.88,74.12,50.46,140279,322906,463185,30.29,69.71,43.96
2010,"TX-05",87072,165493,252565,34.48,65.52,33.26,118142,193860,312002,37.87,62.13,28.8
2010,"TX-06",116663,174670,291333,40.04,59.96,22.14,167239,204955,372194,44.93,55.07,14.68
2010,"TX-07",152141,147354,299495,50.8,49.2,0.620000000000005,205130,172397,377527,54.34,45.66,-4.13999999999999
2010,"TX-08",73292,262809,336101,21.81,78.19,58.6,107360,328809,436169,24.61,75.39,55.32
2010,"TX-09",143254,30502,173756,82.45,17.55,-62.68,167262,50669,217931,76.75,23.25,-48.96
2010,"TX-10",191168,207543,398711,47.95,52.05,6.32,289292,269887,559179,51.74,48.26,1.06000000000001
2010,"TX-11",49972,190287,240259,20.8,79.2,60.62,61513,231738,293251,20.98,79.02,62.58
2010,"TX-12",102983,191220,294203,35,65,32.22,153175,242954,396129,38.67,61.33,27.2
2010,"TX-13",38586,180559,219145,17.61,82.39,67,51398,206638,258036,19.92,80.08,64.7
2010,"TX-14",96689,209034,305723,31.63,68.37,38.96,134490,261008,395498,34.01,65.99,36.52
2010,"TX-15",116461,78345,194806,59.78,40.22,-17.34,127215,118216,245431,51.83,48.17,0.88000000000001
2010,"TX-16",140873,53332,194205,72.54,27.46,-42.86,170451,80302,250753,67.98,32.02,-31.42
2010,"TX-17",75442,190476,265918,28.37,71.63,45.48,106435,234716,341151,31.2,68.8,42.14
2010,"TX-18",159385,41154,200539,79.48,20.52,-56.74,193704,60781,254485,76.12,23.88,-47.7
2010,"TX-19",53689,169769,223458,24.03,75.97,54.16,71617,200758,272375,26.29,73.71,51.96
2010,"TX-20",126312,54936,181248,69.69,30.31,-37.16,163770,73157,236927,69.12,30.88,-33.7
2010,"TX-21",170525,225145,395670,43.1,56.9,16.02,246075,279698,525773,46.8,53.2,10.94
2010,"TX-22",167902,187691,355593,47.22,52.78,7.78,239121,239026,478147,50.01,49.99,4.52000000000001
2010,"TX-23",151384,131452,282836,53.52,46.48,-4.82000000000001,204864,182379,387243,52.9,47.1,-1.26000000000001
2010,"TX-24",144160,139418,283578,50.84,49.16,0.539999999999999,206216,161549,367765,56.07,43.93,-7.59999999999999
2010,"TX-25",203338,124460,327798,62.03,37.97,-21.84,297136,160558,457694,64.92,35.08,-25.3
2010,"TX-26",147855,218217,366072,40.39,59.61,21.44,231092,276869,507961,45.49,54.51,13.56
2010,"TX-27",107860,84616,192476,56.04,43.96,-9.86,122868,118294,241162,50.95,49.05,2.64000000000001
2010,"TX-28",127287,96504,223791,56.88,43.12,-11.54,140546,154047,294593,47.71,52.29,9.12000000000001
2010,"TX-29",87804,32999,120803,72.68,27.32,-43.14,97315,50377,147692,65.89,34.11,-27.24
2010,"TX-30",171710,33993,205703,83.47,16.53,-64.72,210685,46031,256716,82.07,17.93,-59.6
2010,"TX-31",134247,193853,328100,40.92,59.08,20.38,216967,254162,471129,46.05,53.95,12.44
2010,"TX-32",114436,91592,206028,55.54,44.46,-8.86,154703,105406,260109,59.48,40.52,-14.42
2012,"TX-01",66389,189604,255993,25.93,74.07,50.36,83229,218700,301929,27.57,72.43,49.4
2012,"TX-02",119620,145501,265121,45.12,54.88,11.98,170369,174935,345304,49.34,50.66,5.86000000000001
2012,"TX-03",129384,174561,303945,42.57,57.43,17.08,209859,214359,424218,49.47,50.53,5.6
2012,"TX-04",60841,210584,271425,22.42,77.58,57.38,84675,258439,343114,24.68,75.32,55.18
2012,"TX-05",79769,145848,225617,35.36,64.64,31.5,107505,172398,279903,38.41,61.59,27.72
2012,"TX-06",115273,148944,264217,43.63,56.37,14.96,164749,175100,339849,48.48,51.52,7.58
2012,"TX-07",124758,121249,246007,50.71,49.29,0.799999999999997,170117,143238,313355,54.29,45.71,-4.04
2012,"TX-08",70549,214642,285191,24.74,75.26,52.74,109315,274266,383581,28.5,71.5,47.54
2012,"TX-09",151577,34463,186040,81.48,18.52,-60.74,178936,54958,233894,76.5,23.5,-48.46
2012,"TX-10",135964,164861,300825,45.2,54.8,11.82,203947,210713,414660,49.18,50.82,6.18000000000001
2012,"TX-11",47470,193619,241089,19.69,80.31,62.84,58645,235877,294522,19.91,80.09,64.72
2012,"TX-12",92546,177932,270478,34.22,65.78,33.78,140679,224482,365161,38.53,61.47,27.48
2012,"TX-13",40251,190839,231090,17.42,82.58,67.38,54002,219888,273890,19.72,80.28,65.1
2012,"TX-14",101228,153191,254419,39.79,60.21,22.64,124630,185961,310591,40.13,59.87,24.28
2012,"TX-15",104454,73689,178143,58.63,41.37,-15.04,119785,115317,235102,50.95,49.05,2.64000000000001
2012,"TX-16",130784,52334,183118,71.42,28.58,-40.62,160809,77473,238282,67.49,32.51,-30.44
2012,"TX-17",96180,139431,235611,40.82,59.18,20.58,137673,172363,310036,44.41,55.59,15.72
2012,"TX-18",157123,41009,198132,79.3,20.7,-56.38,189831,57668,247499,76.7,23.3,-48.86
2012,"TX-19",53519,165371,218890,24.45,75.55,53.32,71238,195512,266750,26.71,73.29,51.12
2012,"TX-20",132496,74431,206927,64.03,35.97,-25.84,177226,96587,273813,64.73,35.27,-24.92
2012,"TX-21",152443,188304,340747,44.74,55.26,12.74,220458,233073,453531,48.61,51.39,7.32000000000001
2012,"TX-22",135527,159712,295239,45.9,54.1,10.42,206113,210010,416123,49.53,50.47,5.48000000000001
2012,"TX-23",115135,107115,222250,51.8,48.2,-1.38000000000001,146601,152018,298619,49.09,50.91,6.36
2012,"TX-24",122783,140054,262837,46.71,53.29,8.8,180476,161593,342069,52.76,47.24,-0.97999999999999
2012,"TX-25",125938,172482,298420,42.2,57.8,17.82,177797,216273,394070,45.12,54.88,14.3
2012,"TX-26",109582,194090,303672,36.09,63.91,30.04,186033,248256,434289,42.84,57.16,18.86
2012,"TX-27",85589,140787,226376,37.81,62.19,26.6,104511,170800,275311,37.96,62.04,28.62
2012,"TX-28",109946,72471,182417,60.27,39.73,-18.32,125757,115144,240901,52.2,47.8,0.140000000000001
2012,"TX-29",95007,34000,129007,73.64,26.36,-45.06,106202,52923,159125,66.74,33.26,-28.94
2012,"TX-30",174535,40336,214871,81.23,18.77,-60.24,212385,50276,262661,80.86,19.14,-57.18
2012,"TX-31",117172,153809,270981,43.24,56.76,15.74,192580,204077,396657,48.55,51.45,7.44
2012,"TX-32",134884,129696,264580,50.98,49.02,0.259999999999998,187906,151938,339844,55.29,44.71,-6.03999999999998
2012,"TX-33",94552,30812,125364,75.42,24.58,-48.62,117387,41233,158620,74.01,25.99,-43.48
2012,"TX-34",101796,64768,166564,61.12,38.88,-20.02,106838,98533,205371,52.02,47.98,0.500000000000014
2012,"TX-35",128576,61142,189718,67.77,32.23,-33.32,188137,84590,272727,68.98,31.02,-33.42
2012,"TX-36",64225,183175,247400,25.96,74.04,50.3,82881,221600,304481,27.22,72.78,50.1
2014,"TX-01",66389,189604,255993,25.93,74.07,50.36,83229,218700,301929,27.57,72.43,49.4
2014,"TX-02",119620,145501,265121,45.12,54.88,11.98,170369,174935,345304,49.34,50.66,5.86000000000001
2014,"TX-03",129384,174561,303945,42.57,57.43,17.08,209859,214359,424218,49.47,50.53,5.6
2014,"TX-04",60841,210584,271425,22.42,77.58,57.38,84675,258439,343114,24.68,75.32,55.18
2014,"TX-05",79769,145848,225617,35.36,64.64,31.5,107505,172398,279903,38.41,61.59,27.72
2014,"TX-06",115273,148944,264217,43.63,56.37,14.96,164749,175100,339849,48.48,51.52,7.58
2014,"TX-07",124758,121249,246007,50.71,49.29,0.799999999999997,170117,143238,313355,54.29,45.71,-4.04
2014,"TX-08",70549,214642,285191,24.74,75.26,52.74,109315,274266,383581,28.5,71.5,47.54
2014,"TX-09",151577,34463,186040,81.48,18.52,-60.74,178935,54958,233893,76.5,23.5,-48.46
2014,"TX-10",135986,164877,300863,45.2,54.8,11.82,203978,210730,414708,49.19,50.81,6.16000000000001
2014,"TX-11",47470,193619,241089,19.69,80.31,62.84,58645,235877,294522,19.91,80.09,64.72
2014,"TX-12",92546,177932,270478,34.22,65.78,33.78,140679,224482,365161,38.53,61.47,27.48
2014,"TX-13",40251,190839,231090,17.42,82.58,67.38,54002,219888,273890,19.72,80.28,65.1
2014,"TX-14",101228,153191,254419,39.79,60.21,22.64,124630,185961,310591,40.13,59.87,24.28
2014,"TX-15",104461,73691,178152,58.64,41.36,-15.06,119792,115322,235114,50.95,49.05,2.64000000000001
2014,"TX-16",130784,52334,183118,71.42,28.58,-40.62,160809,77473,238282,67.49,32.51,-30.44
2014,"TX-17",96180,139431,235611,40.82,59.18,20.58,137673,172363,310036,44.41,55.59,15.72
2014,"TX-18",157123,41009,198132,79.3,20.7,-56.38,189831,57668,247499,76.7,23.3,-48.86
2014,"TX-19",53519,165371,218890,24.45,75.55,53.32,71238,195512,266750,26.71,73.29,51.12
2014,"TX-20",132496,74431,206927,64.03,35.97,-25.84,177226,96587,273813,64.73,35.27,-24.92
2014,"TX-21",152443,188304,340747,44.74,55.26,12.74,220458,233073,453531,48.61,51.39,7.32000000000001
2014,"TX-22",135527,159712,295239,45.9,54.1,10.42,206114,210010,416124,49.53,50.47,5.48000000000001
2014,"TX-23",115135,107115,222250,51.8,48.2,-1.38000000000001,146601,152018,298619,49.09,50.91,6.36
2014,"TX-24",122783,140054,262837,46.71,53.29,8.8,180476,161593,342069,52.76,47.24,-0.97999999999999
2014,"TX-25",125938,172482,298420,42.2,57.8,17.82,177797,216273,394070,45.12,54.88,14.3
2014,"TX-26",109582,194090,303672,36.09,63.91,30.04,186033,248256,434289,42.84,57.16,18.86
2014,"TX-27",85589,140787,226376,37.81,62.19,26.6,104511,170800,275311,37.96,62.04,28.62
2014,"TX-28",109939,72469,182408,60.27,39.73,-18.32,125750,115139,240889,52.2,47.8,0.140000000000001
2014,"TX-29",95007,34000,129007,73.64,26.36,-45.06,106202,52923,159125,66.74,33.26,-28.94
2014,"TX-30",174535,40336,214871,81.23,18.77,-60.24,212385,50276,262661,80.86,19.14,-57.18
2014,"TX-31",117149,153793,270942,43.24,56.76,15.74,192549,204060,396609,48.55,51.45,7.44
2014,"TX-32",134884,129696,264580,50.98,49.02,0.259999999999998,187906,151938,339844,55.29,44.71,-6.03999999999998
2014,"TX-33",94552,30812,125364,75.42,24.58,-48.62,117387,41233,158620,74.01,25.99,-43.48
2014,"TX-34",101796,64768,166564,61.12,38.88,-20.02,106838,98533,205371,52.02,47.98,0.500000000000014
2014,"TX-35",128576,61142,189718,67.77,32.23,-33.32,188137,84590,272727,68.98,31.02,-33.42
2014,"TX-36",64225,183175,247400,25.96,74.04,50.3,82881,221600,304481,27.22,72.78,50.1
2016,"TX-01",66389,189604,255993,25.93,74.07,50.36,83229,218700,301929,27.57,72.43,49.4
2016,"TX-02",119615,145497,265112,45.12,54.88,11.98,170362,174931,345293,49.34,50.66,5.86000000000001
2016,"TX-03",129384,174561,303945,42.57,57.43,17.08,209859,214359,424218,49.47,50.53,5.6
2016,"TX-04",60841,210584,271425,22.42,77.58,57.38,84675,258439,343114,24.68,75.32,55.18
2016,"TX-05",79769,145848,225617,35.36,64.64,31.5,107505,172398,279903,38.41,61.59,27.72
2016,"TX-06",115255,148911,264166,43.63,56.37,14.96,164733,175069,339802,48.48,51.52,7.58
2016,"TX-07",124732,121229,245961,50.71,49.29,0.799999999999997,170081,143208,313289,54.29,45.71,-4.04
2016,"TX-08",70554,214646,285200,24.74,75.26,52.74,109322,274270,383592,28.5,71.5,47.54
2016,"TX-09",151577,34463,186040,81.48,18.52,-60.74,178935,54958,233893,76.5,23.5,-48.46
2016,"TX-10",136012,164894,300906,45.2,54.8,11.82,204016,210758,414774,49.19,50.81,6.16000000000001
2016,"TX-11",47470,193619,241089,19.69,80.31,62.84,58645,235877,294522,19.91,80.09,64.72
2016,"TX-12",92545,177931,270476,34.22,65.78,33.78,140678,224481,365159,38.53,61.47,27.48
2016,"TX-13",40251,190839,231090,17.42,82.58,67.38,54002,219888,273890,19.72,80.28,65.1
2016,"TX-14",101228,153191,254419,39.79,60.21,22.64,124630,185961,310591,40.13,59.87,24.28
2016,"TX-15",104461,73691,178152,58.64,41.36,-15.06,119792,115322,235114,50.95,49.05,2.64000000000001
2016,"TX-16",130784,52334,183118,71.42,28.58,-40.62,160809,77473,238282,67.49,32.51,-30.44
2016,"TX-17",96180,139431,235611,40.82,59.18,20.58,137673,172363,310036,44.41,55.59,15.72
2016,"TX-18",157123,41009,198132,79.3,20.7,-56.38,189831,57668,247499,76.7,23.3,-48.86
2016,"TX-19",53519,165371,218890,24.45,75.55,53.32,71238,195512,266750,26.71,73.29,51.12
2016,"TX-20",132496,74431,206927,64.03,35.97,-25.84,177226,96587,273813,64.73,35.27,-24.92
2016,"TX-21",152450,188307,340757,44.74,55.26,12.74,220467,233077,453544,48.61,51.39,7.32000000000001
2016,"TX-22",135527,159712,295239,45.9,54.1,10.42,206114,210010,416124,49.53,50.47,5.48000000000001
2016,"TX-23",115135,107115,222250,51.8,48.2,-1.38000000000001,146601,152018,298619,49.09,50.91,6.36
2016,"TX-24",122781,140054,262835,46.71,53.29,8.8,180464,161575,342039,52.76,47.24,-0.97999999999999
2016,"TX-25",125945,172489,298434,42.2,57.8,17.82,177806,216281,394087,45.12,54.88,14.3
2016,"TX-26",109584,194090,303674,36.09,63.91,30.04,186045,248274,434319,42.84,57.16,18.86
2016,"TX-27",85589,140787,226376,37.81,62.19,26.6,104511,170800,275311,37.96,62.04,28.62
2016,"TX-28",109939,72469,182408,60.27,39.73,-18.32,125750,115139,240889,52.2,47.8,0.140000000000001
2016,"TX-29",94998,33997,128995,73.64,26.36,-45.06,106193,52918,159111,66.74,33.26,-28.94
2016,"TX-30",174535,40336,214871,81.23,18.77,-60.24,212385,50276,262661,80.86,19.14,-57.18
2016,"TX-31",117149,153793,270942,43.24,56.76,15.74,192549,204060,396609,48.55,51.45,7.44
2016,"TX-32",134884,129696,264580,50.98,49.02,0.259999999999998,187906,151938,339844,55.29,44.71,-6.03999999999998
2016,"TX-33",94570,30844,125414,75.41,24.59,-48.6,117403,41262,158665,73.99,26.01,-43.44
2016,"TX-34",101796,64768,166564,61.12,38.88,-20.02,106838,98533,205371,52.02,47.98,0.500000000000014
2016,"TX-35",128563,61137,189700,67.77,32.23,-33.32,188118,84583,272701,68.98,31.02,-33.42
2016,"TX-36",64234,183178,247412,25.96,74.04,50.3,82890,221605,304495,27.22,72.78,50.1
2018,"TX-01",66389,189604,255993,25.93,74.07,50.36,83229,218700,301929,27.57,72.43,49.4
2018,"TX-02",119617,145500,265117,45.12,54.88,11.98,170366,174936,345302,49.34,50.66,5.86000000000001
2018,"TX-03",129390,174571,303961,42.57,57.43,17.08,209868,214369,424237,49.47,50.53,5.6
2018,"TX-04",60841,210584,271425,22.42,77.58,57.38,84675,258439,343114,24.68,75.32,55.18
2018,"TX-05",79822,145891,225713,35.36,64.64,31.5,107555,172442,279997,38.41,61.59,27.72
2018,"TX-06",115261,148908,264169,43.63,56.37,14.96,164741,175066,339807,48.48,51.52,7.58
2018,"TX-07",124730,121226,245956,50.71,49.29,0.799999999999997,170077,143203,313280,54.29,45.71,-4.04
2018,"TX-08",70554,214646,285200,24.74,75.26,52.74,109322,274270,383592,28.5,71.5,47.54
2018,"TX-09",151505,34472,185977,81.46,18.54,-60.7,178863,54968,233831,76.49,23.51,-48.44
2018,"TX-10",136003,164891,300894,45.2,54.8,11.82,204005,210755,414760,49.19,50.81,6.16000000000001
2018,"TX-11",47470,193619,241089,19.69,80.31,62.84,58645,235877,294522,19.91,80.09,64.72
2018,"TX-12",92526,177854,270380,34.22,65.78,33.78,140651,224391,365042,38.53,61.47,27.48
2018,"TX-13",40268,190914,231182,17.42,82.58,67.38,54027,219975,274002,19.72,80.28,65.1
2018,"TX-14",101228,153191,254419,39.79,60.21,22.64,124630,185961,310591,40.13,59.87,24.28
2018,"TX-15",104461,73691,178152,58.64,41.36,-15.06,119792,115322,235114,50.95,49.05,2.64000000000001
2018,"TX-16",130784,52334,183118,71.42,28.58,-40.62,160809,77473,238282,67.49,32.51,-30.44
2018,"TX-17",96179,139428,235607,40.82,59.18,20.58,137671,172360,310031,44.41,55.59,15.72
2018,"TX-18",157132,41012,198144,79.3,20.7,-56.38,189840,57673,247513,76.7,23.3,-48.86
2018,"TX-19",53519,165371,218890,24.45,75.55,53.32,71238,195512,266750,26.71,73.29,51.12
2018,"TX-20",132496,74431,206927,64.03,35.97,-25.84,177226,96587,273813,64.73,35.27,-24.92
2018,"TX-21",152466,188319,340785,44.74,55.26,12.74,220481,233090,453571,48.61,51.39,7.32000000000001
2018,"TX-22",135599,159703,295302,45.92,54.08,10.38,206186,210000,416186,49.54,50.46,5.46000000000002
2018,"TX-23",115135,107115,222250,51.8,48.2,-1.38000000000001,146601,152018,298619,49.09,50.91,6.36
2018,"TX-24",122770,140046,262816,46.71,53.29,8.8,180448,161565,342013,52.76,47.24,-0.97999999999999
2018,"TX-25",125914,172476,298390,42.2,57.8,17.82,177771,216266,394037,45.12,54.88,14.3
2018,"TX-26",109595,194098,303693,36.09,63.91,30.04,186061,248284,434345,42.84,57.16,18.86
2018,"TX-27",85589,140787,226376,37.81,62.19,26.6,104511,170800,275311,37.96,62.04,28.62
2018,"TX-28",109939,72469,182408,60.27,39.73,-18.32,125750,115139,240889,52.2,47.8,0.140000000000001
2018,"TX-29",94989,33994,128983,73.64,26.36,-45.06,106184,52913,159097,66.74,33.26,-28.94
2018,"TX-30",174531,40334,214865,81.23,18.77,-60.24,212381,50273,262654,80.86,19.14,-57.18
2018,"TX-31",117160,153799,270959,43.24,56.76,15.74,192564,204067,396631,48.55,51.45,7.44
2018,"TX-32",134829,129645,264474,50.98,49.02,0.259999999999998,187851,151887,339738,55.29,44.71,-6.03999999999998
2018,"TX-33",94566,30849,125415,75.4,24.6,-48.58,117397,41268,158665,73.99,26.01,-43.44
2018,"TX-34",101796,64768,166564,61.12,38.88,-20.02,106838,98533,205371,52.02,47.98,0.500000000000014
2018,"TX-35",128577,61138,189715,67.77,32.23,-33.32,188137,84584,272721,68.99,31.01,-33.44
2018,"TX-36",64234,183178,247412,25.96,74.04,50.3,82890,221605,304495,27.22,72.78,50.1
2020,"TX-01",66389,189604,255993,25.93,74.07,50.36,83229,218700,301929,27.57,72.43,49.4
2020,"TX-02",119613,145512,265125,45.12,54.88,11.98,170368,174958,345326,49.34,50.66,5.86000000000001
2020,"TX-03",129417,174594,304011,42.57,57.43,17.08,209904,214392,424296,49.47,50.53,5.6
2020,"TX-04",60864,210622,271486,22.42,77.58,57.38,84715,258488,343203,24.68,75.32,55.18
2020,"TX-05",79769,145848,225617,35.36,64.64,31.5,107505,172398,279903,38.41,61.59,27.72
2020,"TX-06",115233,148911,264144,43.63,56.37,14.96,164696,175073,339769,48.47,51.53,7.60000000000001
2020,"TX-07",124731,121221,245952,50.71,49.29,0.799999999999997,170075,143200,313275,54.29,45.71,-4.04
2020,"TX-08",70529,214593,285122,24.74,75.26,52.74,109283,274205,383488,28.5,71.5,47.54
2020,"TX-09",151499,34482,185981,81.46,18.54,-60.7,178857,54978,233835,76.49,23.51,-48.44
2020,"TX-10",135979,164881,300860,45.2,54.8,11.82,203969,210722,414691,49.19,50.81,6.16000000000001
2020,"TX-11",47470,193619,241089,19.69,80.31,62.84,58645,235877,294522,19.91,80.09,64.72
2020,"TX-12",92550,177926,270476,34.22,65.78,33.78,140683,224466,365149,38.53,61.47,27.48
2020,"TX-13",40261,190884,231145,17.42,82.58,67.38,54017,219940,273957,19.72,80.28,65.1
2020,"TX-14",101238,153216,254454,39.79,60.21,22.64,124632,185966,310598,40.13,59.87,24.28
2020,"TX-15",104475,73715,178190,58.63,41.37,-15.04,119804,115338,235142,50.95,49.05,2.64000000000001
2020,"TX-16",130777,52324,183101,71.42,28.58,-40.62,160801,77464,238265,67.49,32.51,-30.44
2020,"TX-17",96121,139399,235520,40.81,59.19,20.6,137579,172318,309897,44.4,55.6,15.74
2020,"TX-18",157160,41023,198183,79.3,20.7,-56.38,189875,57687,247562,76.7,23.3,-48.86
2020,"TX-19",53519,165371,218890,24.45,75.55,53.32,71238,195512,266750,26.71,73.29,51.12
2020,"TX-20",132496,74431,206927,64.03,35.97,-25.84,177226,96587,273813,64.73,35.27,-24.92
2020,"TX-21",152434,188298,340732,44.74,55.26,12.74,220446,233067,453513,48.61,51.39,7.32000000000001
2020,"TX-22",135626,159732,295358,45.92,54.08,10.38,206244,210067,416311,49.54,50.46,5.46000000000002
2020,"TX-23",115135,107115,222250,51.8,48.2,-1.38000000000001,146601,152018,298619,49.09,50.91,6.36
2020,"TX-24",122752,140038,262790,46.71,53.29,8.8,180449,161604,342053,52.75,47.25,-0.959999999999994
2020,"TX-25",125953,172482,298435,42.2,57.8,17.82,177812,216261,394073,45.12,54.88,14.3
2020,"TX-26",109563,194039,303602,36.09,63.91,30.04,185991,248179,434170,42.84,57.16,18.86
2020,"TX-27",85579,140776,226355,37.81,62.19,26.6,104498,170787,275285,37.96,62.04,28.62
2020,"TX-28",109942,72470,182412,60.27,39.73,-18.32,125753,115141,240894,52.2,47.8,0.140000000000001
2020,"TX-29",95008,33999,129007,73.65,26.35,-45.08,106208,52919,159127,66.74,33.26,-28.94
2020,"TX-30",174566,40365,214931,81.22,18.78,-60.22,212441,50311,262752,80.85,19.15,-57.16
2020,"TX-31",117202,153816,271018,43.25,56.75,15.72,192631,204103,396734,48.55,51.45,7.44
2020,"TX-32",134861,129651,264512,50.98,49.02,0.259999999999998,187867,151884,339751,55.3,44.7,-6.06
2020,"TX-33",94549,30818,125367,75.42,24.58,-48.62,117373,41235,158608,74,26,-43.46
2020,"TX-34",101796,64768,166564,61.12,38.88,-20.02,106838,98533,205371,52.02,47.98,0.500000000000014
2020,"TX-35",128556,61123,189679,67.78,32.22,-33.34,188115,84578,272693,68.98,31.02,-33.42
2020,"TX-36",64230,183174,247404,25.96,74.04,50.3,82883,221597,304480,27.22,72.78,50.1
2022,"TX-01",69507,204217,273724,25.39,74.61,51.44,85532,233359,318891,26.82,73.18,50.9
2022,"TX-02",79373,158447,237820,33.38,66.62,35.46,121675,194533,316208,38.48,61.52,27.58
2022,"TX-03",91935,162234,254169,36.17,63.83,29.88,151921,203917,355838,42.69,57.31,19.16
2022,"TX-04",81670,174192,255862,31.92,68.08,38.38,126552,217606,344158,36.77,63.23,31
2022,"TX-05",81844,152091,233935,34.99,65.01,32.24,113698,180952,294650,38.59,61.41,27.36
2022,"TX-06",73274,143535,216809,33.8,66.2,34.62,105489,172746,278235,37.91,62.09,28.72
2022,"TX-07",134415,70129,204544,65.71,34.29,-29.2,178648,95929,274577,65.06,34.94,-25.58
2022,"TX-08",73314,146338,219652,33.38,66.62,35.46,112218,197211,309429,36.27,63.73,32
2022,"TX-09",160296,41138,201434,79.58,20.42,-56.94,195566,58464,254030,76.99,23.01,-49.44
2022,"TX-10",89569,158973,248542,36.04,63.96,30.14,135178,199068,334246,40.44,59.56,23.66
2022,"TX-11",58400,151026,209426,27.89,72.11,46.44,77089,185388,262477,29.37,70.63,45.8
2022,"TX-12",86070,149936,236006,36.47,63.53,29.28,129995,188734,318729,40.79,59.21,22.96
2022,"TX-13",56250,187308,243558,23.1,76.9,56.02,78844,215131,293975,26.82,73.18,50.9
2022,"TX-14",89814,165523,255337,35.17,64.83,31.88,110223,200322,310545,35.49,64.51,33.56
2022,"TX-15",98353,74614,172967,56.86,43.14,-11.5,109103,115656,224759,48.54,51.46,7.46
2022,"TX-16",131203,50120,181323,72.36,27.64,-42.5,161715,75945,237660,68.04,31.96,-31.54
2022,"TX-17",81699,150516,232215,35.18,64.82,31.86,114202,182679,296881,38.47,61.53,27.6
2022,"TX-18",143113,42780,185893,76.99,23.01,-51.76,176472,59985,236457,74.63,25.37,-44.72
2022,"TX-19",55631,170909,226540,24.56,75.44,53.1,73236,202928,276164,26.52,73.48,51.5
2022,"TX-20",128153,63257,191410,66.95,33.05,-31.68,172204,85542,257746,66.81,33.19,-29.08
2022,"TX-21",107615,197438,305053,35.28,64.72,31.66,163933,246151,410084,39.98,60.02,24.58
2022,"TX-22",90550,151933,242483,37.34,62.66,27.54,138851,191615,330466,42.02,57.98,20.5
2022,"TX-23",107395,114756,222151,48.34,51.66,5.54,136469,156749,293218,46.54,53.46,11.46
2022,"TX-24",115615,191894,307509,37.6,62.4,27.02,170524,217382,387906,43.96,56.04,16.62
2022,"TX-25",81379,182712,264091,30.81,69.19,40.6,112406,215983,328389,34.23,65.77,36.08
2022,"TX-26",83100,162214,245314,33.87,66.13,34.48,144838,211736,356574,40.62,59.38,23.3
2022,"TX-27",89991,142307,232298,38.74,61.26,24.74,109588,174050,283638,38.64,61.36,27.26
2022,"TX-28",111676,74289,185965,60.05,39.95,-17.88,131818,114121,245939,53.6,46.4,-2.65999999999999
2022,"TX-29",105894,34038,139932,75.68,24.32,-49.14,118878,54382,173260,68.61,31.39,-32.68
2022,"TX-30",175840,46873,222713,78.95,21.05,-55.68,217390,58771,276161,78.72,21.28,-52.9
2022,"TX-31",78959,152479,231438,34.12,65.88,33.98,134319,203301,337620,39.78,60.22,24.98
2022,"TX-32",127503,72983,200486,63.6,36.4,-24.98,172819,86399,259218,66.67,33.33,-28.8
2022,"TX-33",108645,32787,141432,76.82,23.18,-51.42,137056,44710,181766,75.4,24.6,-46.26
2022,"TX-34",109983,49863,159846,68.81,31.19,-35.4,116998,85288,202286,57.84,42.16,-11.14
2022,"TX-35",124495,47573,172068,72.35,27.65,-42.48,188042,69478,257520,73.02,26.98,-41.5
2022,"TX-36",79848,163639,243487,32.79,67.21,36.64,102301,198570,300871,34,66,36.54
2022,"TX-37",217127,74828,291955,74.37,25.63,-46.52,289320,86882,376202,76.91,23.09,-49.28
2022,"TX-38",98328,174936,273264,35.98,64.02,30.26,144121,208870,352991,40.83,59.17,22.88
2008,"UT-01",98064,163879,261943,37.44,62.56,27.34,174852,276530,451382,38.74,61.26,27.06
2008,"UT-02",133408,184212,317620,42,58,18.22,221357,283464,504821,43.85,56.15,16.84
2008,"UT-03",79203,167140,246343,32.15,67.85,37.92,164074,305145,469219,34.97,65.03,34.6
2010,"UT-01",98064,163879,261943,37.44,62.56,27.34,174852,276530,451382,38.74,61.26,27.06
2010,"UT-02",133408,184212,317620,42,58,18.22,221357,283464,504821,43.85,56.15,16.84
2010,"UT-03",79203,167140,246343,32.15,67.85,37.92,164074,305145,469219,34.97,65.03,34.6
2012,"UT-01",62728,139505,202233,31.02,68.98,40.18,113304,230301,343605,32.98,67.02,38.58
2012,"UT-02",90682,130517,221199,41,59,20.22,148894,207660,356554,41.76,58.24,21.02
2012,"UT-03",67439,136776,204215,33.02,66.98,36.18,131843,225838,357681,36.86,63.14,30.82
2012,"UT-04",89822,108432,198254,45.31,54.69,11.6,166234,201339,367573,45.22,54.78,14.1
2014,"UT-01",62729,139508,202237,31.02,68.98,40.18,113306,230306,343612,32.97,67.03,38.6
2014,"UT-02",90681,130518,221199,41,59,20.22,148892,207660,356552,41.76,58.24,21.02
2014,"UT-03",67439,136776,204215,33.02,66.98,36.18,131843,225838,357681,36.86,63.14,30.82
2014,"UT-04",89822,108428,198250,45.31,54.69,11.6,166234,201334,367568,45.23,54.77,14.08
2016,"UT-01",62736,139514,202250,31.02,68.98,40.18,113315,230314,343629,32.98,67.02,38.58
2016,"UT-02",90679,130513,221192,41,59,20.22,148890,207654,356544,41.76,58.24,21.02
2016,"UT-03",67439,136776,204215,33.02,66.98,36.18,131843,225838,357681,36.86,63.14,30.82
2016,"UT-04",89822,108428,198250,45.31,54.69,11.6,166234,201334,367568,45.23,54.77,14.08
2018,"UT-01",62736,139514,202250,31.02,68.98,40.18,113315,230314,343629,32.98,67.02,38.58
2018,"UT-02",90679,130513,221192,41,59,20.22,148890,207654,356544,41.76,58.24,21.02
2018,"UT-03",67442,136778,204220,33.02,66.98,36.18,131843,225838,357681,36.86,63.14,30.82
2018,"UT-04",89819,108426,198245,45.31,54.69,11.6,166234,201334,367568,45.23,54.77,14.08
2020,"UT-01",62737,139518,202255,31.02,68.98,40.18,113314,230311,343625,32.98,67.02,38.58
2020,"UT-02",90740,130524,221264,41.01,58.99,20.2,148969,207674,356643,41.77,58.23,21
2020,"UT-03",67513,136795,204308,33.04,66.96,36.14,131810,225798,357608,36.86,63.14,30.82
2020,"UT-04",89686,108394,198080,45.28,54.72,11.66,166189,201357,367546,45.22,54.78,14.1
2022,"UT-01",85482,131645,217127,39.37,60.63,23.48,142907,216436,359343,39.77,60.23,25
2022,"UT-02",82772,125658,208430,39.71,60.29,22.8,143059,205082,348141,41.09,58.91,22.36
2022,"UT-03",81248,143794,225042,36.1,63.9,30.02,149275,225836,375111,39.79,60.21,24.96
2022,"UT-04",61173,114134,175307,34.89,65.11,32.44,125040,217786,342826,36.47,63.53,31.6
2008,"VT-01",178559,95367,273926,65.19,34.81,-28.16,242802,112701,355503,68.3,31.7,-32.06
2010,"VT-01",178559,95367,273926,65.19,34.81,-28.16,242802,112701,355503,68.3,31.7,-32.06
2012,"VT-01",178559,95367,273926,65.19,34.81,-28.16,242802,112701,355503,68.3,31.7,-32.06
2014,"VT-01",178559,95367,273926,65.19,34.81,-28.16,242802,112701,355503,68.3,31.7,-32.06
2016,"VT-01",178573,95369,273942,65.19,34.81,-28.16,242820,112704,355524,68.3,31.7,-32.06
2018,"VT-01",178573,95369,273942,65.19,34.81,-28.16,242820,112704,355524,68.3,31.7,-32.06
2020,"VT-01",178573,95369,273942,65.19,34.81,-28.16,242820,112704,355524,68.3,31.7,-32.06
2022,"VT-01",178573,95369,273942,65.19,34.81,-28.16,242820,112704,355524,68.3,31.7,-32.06
2008,"VA-01",176761,202588,379349,46.6,53.4,9.02,221886,223237,445123,49.85,50.15,4.84
2008,"VA-02",132610,132923,265533,49.94,50.06,2.34,165631,141615,307246,53.91,46.09,-3.28
2008,"VA-03",218492,72756,291248,75.02,24.98,-47.82,249812,78770,328582,76.03,23.97,-47.52
2008,"VA-04",172118,180754,352872,48.78,51.22,4.66,208225,199900,408125,51.02,48.98,2.50000000000001
2008,"VA-05",144761,178211,322972,44.82,55.18,12.58,169227,197086,366313,46.2,53.8,12.14
2008,"VA-06",118839,198110,316949,37.49,62.51,27.24,146600,220105,366705,39.98,60.02,24.58
2008,"VA-07",186159,209624,395783,47.04,52.96,8.13999999999999,239090,237025,476115,50.22,49.78,4.10000000000001
2008,"VA-08",268770,72944,341714,78.65,21.35,-55.08,308451,80019,388470,79.4,20.6,-54.26
2008,"VA-09",74753,198485,273238,27.36,72.64,47.5,85283,224698,309981,27.51,72.49,49.52
2008,"VA-10",242924,189690,432614,56.15,43.85,-10.08,321298,214092,535390,60.01,39.99,-15.48
2008,"VA-11",245286,133358,378644,64.78,35.22,-27.34,298066,145885,443951,67.14,32.86,-29.74
2010,"VA-01",176761,202588,379349,46.6,53.4,9.02,221886,223237,445123,49.85,50.15,4.84
2010,"VA-02",132610,132923,265533,49.94,50.06,2.34,165631,141615,307246,53.91,46.09,-3.28
2010,"VA-03",218492,72756,291248,75.02,24.98,-47.82,249812,78770,328582,76.03,23.97,-47.52
2010,"VA-04",172118,180754,352872,48.78,51.22,4.66,208225,199900,408125,51.02,48.98,2.50000000000001
2010,"VA-05",144761,178211,322972,44.82,55.18,12.58,169227,197086,366313,46.2,53.8,12.14
2010,"VA-06",118839,198110,316949,37.49,62.51,27.24,146600,220105,366705,39.98,60.02,24.58
2010,"VA-07",186159,209624,395783,47.04,52.96,8.13999999999999,239090,237025,476115,50.22,49.78,4.10000000000001
2010,"VA-08",268770,72944,341714,78.65,21.35,-55.08,308451,80019,388470,79.4,20.6,-54.26
2010,"VA-09",74753,198485,273238,27.36,72.64,47.5,85283,224698,309981,27.51,72.49,49.52
2010,"VA-10",242924,189690,432614,56.15,43.85,-10.08,321298,214092,535390,60.01,39.99,-15.48
2010,"VA-11",245286,133358,378644,64.78,35.22,-27.34,298066,145885,443951,67.14,32.86,-29.74
2012,"VA-01",164388,193875,358263,45.88,54.12,10.46,215286,212144,427430,50.37,49.63,3.8
2012,"VA-02",148834,148587,297421,50.04,49.96,2.14000000000001,181654,157078,338732,53.63,46.37,-2.72
2012,"VA-03",249152,69926,319078,78.08,21.92,-53.94,283929,75188,359117,79.06,20.94,-53.58
2012,"VA-04",163857,180575,344432,47.57,52.43,7.08,200425,199075,399500,50.17,49.83,4.20000000000001
2012,"VA-05",154635,195114,349749,44.21,55.79,13.8,183136,217455,400591,45.72,54.28,13.1
2012,"VA-06",120626,206385,327011,36.89,63.11,28.44,149293,231338,380631,39.22,60.78,26.1
2012,"VA-07",173319,211439,384758,45.05,54.95,12.12,226986,238091,465077,48.81,51.19,6.92000000000002
2012,"VA-08",270105,76758,346863,77.87,22.13,-53.52,311186,84616,395802,78.62,21.38,-52.7
2012,"VA-09",86448,217805,304253,28.41,71.59,45.4,98634,244963,343597,28.71,71.29,47.12
2012,"VA-10",210809,170654,381463,55.26,44.74,-8.3,282054,189483,471537,59.82,40.18,-15.1
2012,"VA-11",239300,98325,337625,70.88,29.12,-39.54,280985,112999,393984,71.32,28.68,-38.1
2014,"VA-01",164376,193869,358245,45.88,54.12,10.46,215275,212136,427411,50.37,49.63,3.8
2014,"VA-02",148849,148591,297440,50.04,49.96,2.14000000000001,181666,157083,338749,53.63,46.37,-2.72
2014,"VA-03",249137,69922,319059,78.08,21.92,-53.94,283917,75183,359100,79.06,20.94,-53.58
2014,"VA-04",163857,180575,344432,47.57,52.43,7.08,200425,199075,399500,50.17,49.83,4.20000000000001
2014,"VA-05",154635,195114,349749,44.21,55.79,13.8,183136,217455,400591,45.72,54.28,13.1
2014,"VA-06",120626,206385,327011,36.89,63.11,28.44,149293,231338,380631,39.22,60.78,26.1
2014,"VA-07",173319,211439,384758,45.05,54.95,12.12,226986,238091,465077,48.81,51.19,6.92000000000002
2014,"VA-08",270057,76744,346801,77.87,22.13,-53.52,311154,84603,395757,78.62,21.38,-52.7
2014,"VA-09",86448,217805,304253,28.41,71.59,45.4,98634,244963,343597,28.71,71.29,47.12
2014,"VA-10",210786,170640,381426,55.26,44.74,-8.3,282024,189467,471491,59.82,40.18,-15.1
2014,"VA-11",239383,98359,337742,70.88,29.12,-39.54,281058,113036,394094,71.32,28.68,-38.1
2016,"VA-01",161561,210781,372342,43.39,56.61,15.44,213293,233314,446607,47.76,52.24,9.02
2016,"VA-02",146984,157831,304815,48.22,51.78,5.78,186220,169276,355496,52.38,47.62,-0.219999999999992
2016,"VA-03",205770,103075,308845,66.63,33.37,-31.04,233829,108810,342639,68.24,31.76,-31.94
2016,"VA-04",212546,134658,347204,61.22,38.78,-20.22,246444,146891,393335,62.65,37.35,-20.76
2016,"VA-05",154635,195112,349747,44.21,55.79,13.8,183132,217449,400581,45.72,54.28,13.1
2016,"VA-06",120626,206387,327013,36.89,63.11,28.44,149297,231344,380641,39.22,60.78,26.1
2016,"VA-07",172677,198051,370728,46.58,53.42,9.06,228483,223277,451760,50.58,49.42,3.38
2016,"VA-08",270057,76744,346801,77.87,22.13,-53.52,311154,84603,395757,78.62,21.38,-52.7
2016,"VA-09",86448,217805,304253,28.41,71.59,45.4,98634,244963,343597,28.71,71.29,47.12
2016,"VA-10",210786,170640,381426,55.26,44.74,-8.3,282024,189467,471491,59.82,40.18,-15.1
2016,"VA-11",239383,98359,337742,70.88,29.12,-39.54,281058,113036,394094,71.32,28.68,-38.1
2018,"VA-01",161572,210789,372361,43.39,56.61,15.44,213349,233351,446700,47.76,52.24,9.02
2018,"VA-02",146904,157780,304684,48.22,51.78,5.78,186017,169187,355204,52.37,47.63,-0.199999999999996
2018,"VA-03",205865,103139,309004,66.62,33.38,-31.02,234059,108919,342978,68.24,31.76,-31.94
2018,"VA-04",212677,134657,347334,61.23,38.77,-20.24,246574,146882,393456,62.67,37.33,-20.8
2018,"VA-05",154665,195190,349855,44.21,55.79,13.8,183175,217535,400710,45.71,54.29,13.12
2018,"VA-06",120598,206307,326905,36.89,63.11,28.44,149258,231253,380511,39.23,60.77,26.08
2018,"VA-07",172544,198033,370577,46.56,53.44,9.09999999999999,228329,223254,451583,50.56,49.44,3.42
2018,"VA-08",270067,76753,346820,77.87,22.13,-53.52,311170,84614,395784,78.62,21.38,-52.7
2018,"VA-09",86461,217833,304294,28.41,71.59,45.4,98649,244991,343640,28.71,71.29,47.12
2018,"VA-10",210747,170614,381361,55.26,44.74,-8.3,281944,189416,471360,59.82,40.18,-15.1
2018,"VA-11",239373,98348,337721,70.88,29.12,-39.54,281044,113028,394072,71.32,28.68,-38.1
2020,"VA-01",161565,210779,372344,43.39,56.61,15.44,213343,233337,446680,47.76,52.24,9.02
2020,"VA-02",146936,157810,304746,48.22,51.78,5.78,186060,169219,355279,52.37,47.63,-0.199999999999996
2020,"VA-03",205844,103116,308960,66.62,33.38,-31.02,234028,108895,342923,68.25,31.75,-31.96
2020,"VA-04",212666,134650,347316,61.23,38.77,-20.24,246562,146874,393436,62.67,37.33,-20.8
2020,"VA-05",154665,195190,349855,44.21,55.79,13.8,183175,217535,400710,45.71,54.29,13.12
2020,"VA-06",120598,206307,326905,36.89,63.11,28.44,149258,231253,380511,39.23,60.77,26.08
2020,"VA-07",172551,198043,370594,46.56,53.44,9.09999999999999,228335,223268,451603,50.56,49.44,3.42
2020,"VA-08",270067,76753,346820,77.87,22.13,-53.52,311170,84614,395784,78.62,21.38,-52.7
2020,"VA-09",86461,217833,304294,28.41,71.59,45.4,98649,244991,343640,28.71,71.29,47.12
2020,"VA-10",210747,170614,381361,55.26,44.74,-8.3,281944,189416,471360,59.82,40.18,-15.1
2020,"VA-11",239373,98348,337721,70.88,29.12,-39.54,281044,113028,394072,71.32,28.68,-38.1
2022,"VA-01",164245,220031,384276,42.74,57.26,16.74,210643,241490,452133,46.59,53.41,11.36
2022,"VA-02",158931,178811,337742,47.06,52.94,8.09999999999999,202878,194367,397245,51.07,48.93,2.4
2022,"VA-03",202831,97440,300271,67.55,32.45,-32.88,229555,100971,330526,69.45,30.55,-34.36
2022,"VA-04",226509,114332,340841,66.46,33.54,-30.7,264651,123605,388256,68.16,31.84,-31.78
2022,"VA-05",163702,207993,371695,44.04,55.96,14.14,195810,231761,427571,45.8,54.2,12.94
2022,"VA-06",119840,209352,329192,36.4,63.6,29.42,151506,239666,391172,38.73,61.27,27.08
2022,"VA-07",159025,151872,310897,51.15,48.85,-0.0799999999999983,204702,178392,383094,53.43,46.57,-2.31999999999999
2022,"VA-08",266272,76494,342766,77.68,22.32,-53.14,306018,84596,390614,78.34,21.66,-52.14
2022,"VA-09",99371,250229,349600,28.42,71.58,45.38,113677,281773,395450,28.75,71.25,47.04
2022,"VA-10",175714,149008,324722,54.11,45.89,-6,240787,165657,406444,59.24,40.76,-13.94
2022,"VA-11",245033,113881,358914,68.27,31.73,-34.32,293342,120152,413494,70.94,29.06,-37.34
2008,"WA-01",242448,112851,355299,68.24,31.76,-34.26,321131,136328,457459,70.2,29.8,-35.86
2008,"WA-02",189974,157522,347496,54.67,45.33,-7.12,269018,204796,473814,56.78,43.22,-9.01999999999999
2008,"WA-03",169827,175432,345259,49.19,50.81,3.84,246978,238502,485480,50.87,49.13,2.8
2008,"WA-04",105377,166142,271519,38.81,61.19,24.6,153562,213343,366905,41.85,58.15,20.84
2008,"WA-05",132300,179782,312082,42.39,57.61,17.44,189004,231493,420497,44.95,55.05,14.64
2008,"WA-06",167599,128457,296056,56.61,43.39,-11,238534,167019,405553,58.82,41.18,-13.1
2008,"WA-07",353698,40116,393814,89.81,10.19,-77.4,425955,50477,476432,89.41,10.59,-74.28
2008,"WA-08",221247,147750,368997,59.96,40.04,-17.7,300231,191194,491425,61.09,38.91,-17.64
2008,"WA-09",160246,113693,273939,58.5,41.5,-14.78,224979,151302,376281,59.79,40.21,-15.04
2010,"WA-01",242448,112851,355299,68.24,31.76,-34.26,321131,136328,457459,70.2,29.8,-35.86
2010,"WA-02",189974,157522,347496,54.67,45.33,-7.12,269018,204796,473814,56.78,43.22,-9.01999999999999
2010,"WA-03",169827,175432,345259,49.19,50.81,3.84,246978,238502,485480,50.87,49.13,2.8
2010,"WA-04",105377,166142,271519,38.81,61.19,24.6,153562,213343,366905,41.85,58.15,20.84
2010,"WA-05",132300,179782,312082,42.39,57.61,17.44,189004,231493,420497,44.95,55.05,14.64
2010,"WA-06",167599,128457,296056,56.61,43.39,-11,238534,167019,405553,58.82,41.18,-13.1
2010,"WA-07",353698,40116,393814,89.81,10.19,-77.4,425955,50477,476432,89.41,10.59,-74.28
2010,"WA-08",221247,147750,368997,59.96,40.04,-17.7,300231,191194,491425,61.09,38.91,-17.64
2010,"WA-09",160246,113693,273939,58.5,41.5,-14.78,224979,151302,376281,59.79,40.21,-15.04
2012,"WA-01",189007,132141,321148,58.85,41.15,-15.48,257689,166496,424185,60.75,39.25,-16.96
2012,"WA-02",185846,113671,299517,62.05,37.95,-21.88,257335,145140,402475,63.94,36.06,-23.34
2012,"WA-03",134009,157360,291369,45.99,54.01,10.24,198213,214201,412414,48.06,51.94,8.42
2012,"WA-04",85091,140576,225667,37.71,62.29,26.8,122707,179044,301751,40.66,59.34,23.22
2012,"WA-05",125110,166762,291872,42.86,57.14,16.5,178891,215699,394590,45.34,54.66,13.86
2012,"WA-06",172611,131461,304072,56.77,43.23,-11.32,244163,168269,412432,59.2,40.8,-13.86
2012,"WA-07",341430,50614,392044,87.09,12.91,-71.96,410066,58832,468898,87.45,12.55,-70.36
2012,"WA-08",152898,143255,296153,51.63,48.37,-1.03999999999999,217885,190574,408459,53.34,46.66,-2.13999999999999
2012,"WA-09",205363,68070,273433,75.11,24.89,-48,265670,89167,354837,74.87,25.13,-45.2
2012,"WA-10",151350,117834,269184,56.23,43.77,-10.24,216773,157032,373805,57.99,42.01,-11.44
2014,"WA-01",189009,132142,321151,58.85,41.15,-15.48,257691,166497,424188,60.75,39.25,-16.96
2014,"WA-02",185844,113670,299514,62.05,37.95,-21.88,257333,145139,402472,63.94,36.06,-23.34
2014,"WA-03",134009,157360,291369,45.99,54.01,10.24,198213,214201,412414,48.06,51.94,8.42
2014,"WA-04",85091,140576,225667,37.71,62.29,26.8,122707,179044,301751,40.66,59.34,23.22
2014,"WA-05",125110,166762,291872,42.86,57.14,16.5,178891,215699,394590,45.34,54.66,13.86
2014,"WA-06",172611,131461,304072,56.77,43.23,-11.32,244163,168269,412432,59.2,40.8,-13.86
2014,"WA-07",341430,50614,392044,87.09,12.91,-71.96,410066,58832,468898,87.45,12.55,-70.36
2014,"WA-08",152894,143253,296147,51.63,48.37,-1.03999999999999,217877,190570,408447,53.34,46.66,-2.13999999999999
2014,"WA-09",205363,68070,273433,75.11,24.89,-48,265670,89167,354837,74.87,25.13,-45.2
2014,"WA-10",151354,117836,269190,56.23,43.77,-10.24,216781,157036,373817,57.99,42.01,-11.44
2016,"WA-01",189023,132143,321166,58.86,41.14,-15.5,257711,166490,424201,60.75,39.25,-16.96
2016,"WA-02",185819,113667,299486,62.05,37.95,-21.88,257300,145144,402444,63.93,36.07,-23.32
2016,"WA-03",134012,157366,291378,45.99,54.01,10.24,198220,214213,412433,48.06,51.94,8.42
2016,"WA-04",85087,140569,225656,37.71,62.29,26.8,122702,179036,301738,40.67,59.33,23.2
2016,"WA-05",125110,166762,291872,42.86,57.14,16.5,178891,215699,394590,45.34,54.66,13.86
2016,"WA-06",172596,131446,304042,56.77,43.23,-11.32,244141,168250,412391,59.2,40.8,-13.86
2016,"WA-07",341441,50616,392057,87.09,12.91,-71.96,410079,58834,468913,87.45,12.55,-70.36
2016,"WA-08",152893,143252,296145,51.63,48.37,-1.03999999999999,217874,190566,408440,53.34,46.66,-2.13999999999999
2016,"WA-09",205363,68070,273433,75.11,24.89,-48,265671,89168,354839,74.87,25.13,-45.2
2016,"WA-10",151372,117853,269225,56.23,43.77,-10.24,216805,157056,373861,57.99,42.01,-11.44
2018,"WA-01",188977,132121,321098,58.85,41.15,-15.48,257660,166467,424127,60.75,39.25,-16.96
2018,"WA-02",185831,113672,299503,62.05,37.95,-21.88,257310,145148,402458,63.93,36.07,-23.32
2018,"WA-03",134016,157371,291387,45.99,54.01,10.24,198227,214221,412448,48.06,51.94,8.42
2018,"WA-04",85087,140569,225656,37.71,62.29,26.8,122702,179036,301738,40.67,59.33,23.2
2018,"WA-05",125110,166762,291872,42.86,57.14,16.5,178891,215699,394590,45.34,54.66,13.86
2018,"WA-06",172596,131446,304042,56.77,43.23,-11.32,244145,168253,412398,59.2,40.8,-13.86
2018,"WA-07",341443,50618,392061,87.09,12.91,-71.96,410070,58834,468904,87.45,12.55,-70.36
2018,"WA-08",152994,143310,296304,51.63,48.37,-1.03999999999999,218015,190650,408665,53.35,46.65,-2.15999999999998
2018,"WA-09",205304,68033,273337,75.11,24.89,-48,265596,89115,354711,74.88,25.12,-45.22
2018,"WA-10",151358,117842,269200,56.23,43.77,-10.24,216778,157033,373811,57.99,42.01,-11.44
2020,"WA-01",188522,131806,320328,58.85,41.15,-15.48,257090,166079,423169,60.75,39.25,-16.96
2020,"WA-02",186288,113990,300278,62.04,37.96,-21.86,257868,145537,403405,63.92,36.08,-23.3
2020,"WA-03",134010,157364,291374,45.99,54.01,10.24,198218,214211,412429,48.06,51.94,8.42
2020,"WA-04",85087,140568,225655,37.71,62.29,26.8,122701,179035,301736,40.67,59.33,23.2
2020,"WA-05",125110,166762,291872,42.86,57.14,16.5,178891,215699,394590,45.34,54.66,13.86
2020,"WA-06",172597,131447,304044,56.77,43.23,-11.32,244143,168251,412394,59.2,40.8,-13.86
2020,"WA-07",341433,50613,392046,87.09,12.91,-71.96,410076,58835,468911,87.45,12.55,-70.36
2020,"WA-08",152981,143302,296283,51.63,48.37,-1.03999999999999,218014,190645,408659,53.35,46.65,-2.15999999999998
2020,"WA-09",205324,68043,273367,75.11,24.89,-48,265606,89121,354727,74.88,25.12,-45.22
2020,"WA-10",151364,117849,269213,56.22,43.78,-10.22,216787,157043,373830,57.99,42.01,-11.44
2022,"WA-01",185658,104200,289858,64.05,35.95,-25.88,250571,130265,380836,65.79,34.21,-27.04
2022,"WA-02",190699,128477,319176,59.75,40.25,-17.28,262936,162774,425710,61.76,38.24,-18.98
2022,"WA-03",132315,155901,288216,45.91,54.09,10.4,195989,213686,409675,47.84,52.16,8.86000000000001
2022,"WA-04",89939,144503,234442,38.36,61.64,25.5,130041,184644,314685,41.32,58.68,21.9
2022,"WA-05",126610,172495,299105,42.33,57.67,17.56,180898,222431,403329,44.85,55.15,14.84
2022,"WA-06",179587,138169,317756,56.52,43.48,-10.82,253584,177162,430746,58.87,41.13,-13.2
2022,"WA-07",331238,43789,375027,88.32,11.68,-74.42,396780,51402,448182,88.53,11.47,-72.52
2022,"WA-08",161297,150458,311755,51.74,48.26,-1.26,227743,198395,426138,53.44,46.56,-2.33999999999999
2022,"WA-09",194355,70563,264918,73.36,26.64,-44.5,254212,94095,348307,72.99,27.01,-41.44
2022,"WA-10",151019,113188,264207,57.16,42.84,-12.1,216640,149603,366243,59.15,40.85,-13.76
2008,"WV-01",67293,175580,242873,27.71,72.29,46.8,81849,183904,265753,30.8,69.2,42.94
2008,"WV-02",75568,172328,247896,30.48,69.52,41.26,95149,193275,288424,32.99,67.01,38.56
2008,"WV-03",62129,178210,240339,25.85,74.15,50.52,58985,168200,227185,25.96,74.04,52.62
2010,"WV-01",67293,175580,242873,27.71,72.29,46.8,81849,183904,265753,30.8,69.2,42.94
2010,"WV-02",75568,172328,247896,30.48,69.52,41.26,95149,193275,288424,32.99,67.01,38.56
2010,"WV-03",62129,178210,240339,25.85,74.15,50.52,58985,168200,227185,25.96,74.04,52.62
2012,"WV-01",67293,175580,242873,27.71,72.29,46.8,81849,183904,265753,30.8,69.2,42.94
2012,"WV-02",73487,164674,238161,30.86,69.14,40.5,92623,184784,277407,33.39,66.61,37.76
2012,"WV-03",64210,185864,250074,25.68,74.32,50.86,61511,176691,238202,25.82,74.18,52.9
2014,"WV-01",67293,175580,242873,27.71,72.29,46.8,81849,183904,265753,30.8,69.2,42.94
2014,"WV-02",73487,164674,238161,30.86,69.14,40.5,92623,184784,277407,33.39,66.61,37.76
2014,"WV-03",64210,185864,250074,25.68,74.32,50.86,61511,176691,238202,25.82,74.18,52.9
2016,"WV-01",67293,175580,242873,27.71,72.29,46.8,81849,183904,265753,30.8,69.2,42.94
2016,"WV-02",73487,164674,238161,30.86,69.14,40.5,92623,184784,277407,33.39,66.61,37.76
2016,"WV-03",64210,185864,250074,25.68,74.32,50.86,61512,176694,238206,25.82,74.18,52.9
2018,"WV-01",67293,175580,242873,27.71,72.29,46.8,81849,183904,265753,30.8,69.2,42.94
2018,"WV-02",73487,164674,238161,30.86,69.14,40.5,92623,184784,277407,33.39,66.61,37.76
2018,"WV-03",64210,185864,250074,25.68,74.32,50.86,61512,176694,238206,25.82,74.18,52.9
2020,"WV-01",67293,175580,242873,27.71,72.29,46.8,81849,183904,265753,30.8,69.2,42.94
2020,"WV-02",73487,164674,238161,30.86,69.14,40.5,92623,184784,277407,33.39,66.61,37.76
2020,"WV-03",64210,185864,250074,25.68,74.32,50.86,61512,176694,238206,25.82,74.18,52.9
2022,"WV-01",106247,274380,380627,27.91,72.09,46.4,112947,273523,386470,29.23,70.77,46.08
2022,"WV-02",98743,251738,350481,28.17,71.83,45.88,123037,271859,394896,31.16,68.84,42.22
2008,"WI-01",155272,187573,342845,45.29,54.71,11.64,188577,220243,408820,46.13,53.87,12.28
2008,"WI-02",281692,130019,411711,68.42,31.58,-34.62,335397,147250,482647,69.49,30.51,-34.44
2008,"WI-03",161655,184832,346487,46.66,53.34,8.89999999999999,189144,215004,404148,46.8,53.2,10.94
2008,"WI-04",206399,60143,266542,77.44,22.56,-52.66,215592,64271,279863,77.03,22.97,-49.52
2008,"WI-05",163914,233872,397786,41.21,58.79,19.8,210011,260192,470203,44.66,55.34,15.22
2008,"WI-06",131849,204216,336065,39.23,60.77,23.76,156455,236187,392642,39.85,60.15,24.84
2008,"WI-07",139333,196193,335526,41.53,58.47,19.16,162297,226490,388787,41.74,58.26,21.06
2008,"WI-08",142238,208284,350522,40.58,59.42,21.06,173249,240479,413728,41.88,58.12,20.78
2010,"WI-01",155272,187573,342845,45.29,54.71,11.64,188577,220243,408820,46.13,53.87,12.28
2010,"WI-02",281692,130019,411711,68.42,31.58,-34.62,335397,147250,482647,69.49,30.51,-34.44
2010,"WI-03",161655,184832,346487,46.66,53.34,8.89999999999999,189144,215004,404148,46.8,53.2,10.94
2010,"WI-04",206399,60143,266542,77.44,22.56,-52.66,215592,64271,279863,77.03,22.97,-49.52
2010,"WI-05",163914,233872,397786,41.21,58.79,19.8,210011,260192,470203,44.66,55.34,15.22
2010,"WI-06",131849,204216,336065,39.23,60.77,23.76,156455,236187,392642,39.85,60.15,24.84
2010,"WI-07",139333,196193,335526,41.53,58.47,19.16,162297,226490,388787,41.74,58.26,21.06
2010,"WI-08",142238,208284,350522,40.58,59.42,21.06,173249,240479,413728,41.88,58.12,20.78
2012,"WI-01",150557,187526,338083,44.53,55.47,13.16,183066,220801,403867,45.33,54.67,13.88
2012,"WI-02",271516,119614,391130,69.42,30.58,-36.62,323822,136450,460272,70.35,29.65,-36.16
2012,"WI-03",160988,177167,338155,47.61,52.39,7,184289,202627,386916,47.63,52.37,9.28000000000001
2012,"WI-04",228159,67260,295419,77.23,22.77,-52.24,242191,71805,313996,77.13,22.87,-49.72
2012,"WI-05",148827,229195,378022,39.37,60.63,23.48,187771,255695,443466,42.34,57.66,19.86
2012,"WI-06",141934,203436,345370,41.1,58.9,20.02,170450,232744,403194,42.27,57.73,20
2012,"WI-07",137884,213472,351356,39.24,60.76,23.74,165121,248854,413975,39.89,60.11,24.76
2012,"WI-08",142671,207613,350284,40.73,59.27,20.76,174152,241203,415355,41.93,58.07,20.68
2014,"WI-01",150557,187526,338083,44.53,55.47,13.16,183066,220801,403867,45.33,54.67,13.88
2014,"WI-02",271515,119614,391129,69.42,30.58,-36.62,323820,136449,460269,70.35,29.65,-36.16
2014,"WI-03",160987,177163,338150,47.61,52.39,7,184288,202627,386915,47.63,52.37,9.28000000000001
2014,"WI-04",228167,67264,295431,77.23,22.77,-52.24,242199,71809,314008,77.13,22.87,-49.72
2014,"WI-05",148828,229195,378023,39.37,60.63,23.48,187773,255696,443469,42.34,57.66,19.86
2014,"WI-06",141927,203434,345361,41.1,58.9,20.02,170444,232742,403186,42.27,57.73,20
2014,"WI-07",137884,213474,351358,39.24,60.76,23.74,165120,248852,413972,39.89,60.11,24.76
2014,"WI-08",142671,207613,350284,40.73,59.27,20.76,174152,241203,415355,41.93,58.07,20.68
2016,"WI-01",150491,187448,337939,44.53,55.47,13.16,183020,220751,403771,45.33,54.67,13.88
2016,"WI-02",271515,119614,391129,69.42,30.58,-36.62,323820,136449,460269,70.35,29.65,-36.16
2016,"WI-03",160987,177163,338150,47.61,52.39,7,184288,202627,386915,47.63,52.37,9.28000000000001
2016,"WI-04",228225,67292,295517,77.23,22.77,-52.24,242250,71826,314076,77.13,22.87,-49.72
2016,"WI-05",148857,229253,378110,39.37,60.63,23.48,187798,255742,443540,42.34,57.66,19.86
2016,"WI-06",141906,203426,345332,41.09,58.91,20.04,170418,232734,403152,42.27,57.73,20
2016,"WI-07",137884,213474,351358,39.24,60.76,23.74,165120,248852,413972,39.89,60.11,24.76
2016,"WI-08",142671,207613,350284,40.73,59.27,20.76,174152,241203,415355,41.93,58.07,20.68
2018,"WI-01",150448,187385,337833,44.53,55.47,13.16,182929,220646,403575,45.33,54.67,13.88
2018,"WI-02",271515,119614,391129,69.42,30.58,-36.62,323820,136449,460269,70.35,29.65,-36.16
2018,"WI-03",160996,177171,338167,47.61,52.39,7,184306,202646,386952,47.63,52.37,9.28000000000001
2018,"WI-04",228215,67288,295503,77.23,22.77,-52.24,242243,71826,314069,77.13,22.87,-49.72
2018,"WI-05",148901,229311,378212,39.37,60.63,23.48,187886,255834,443720,42.34,57.66,19.86
2018,"WI-06",141914,203433,345347,41.09,58.91,20.04,170427,232744,403171,42.27,57.73,20
2018,"WI-07",137875,213466,351341,39.24,60.76,23.74,165102,248833,413935,39.89,60.11,24.76
2018,"WI-08",142672,207615,350287,40.73,59.27,20.76,174153,241206,415359,41.93,58.07,20.68
2020,"WI-01",150464,187404,337868,44.53,55.47,13.16,182945,220670,403615,45.33,54.67,13.88
2020,"WI-02",271515,119614,391129,69.42,30.58,-36.62,323820,136449,460269,70.35,29.65,-36.16
2020,"WI-03",160996,177171,338167,47.61,52.39,7,184306,202646,386952,47.63,52.37,9.28000000000001
2020,"WI-04",228215,67288,295503,77.23,22.77,-52.24,242243,71826,314069,77.13,22.87,-49.72
2020,"WI-05",148885,229292,378177,39.37,60.63,23.48,187870,255810,443680,42.34,57.66,19.86
2020,"WI-06",141914,203433,345347,41.09,58.91,20.04,170427,232744,403171,42.27,57.73,20
2020,"WI-07",137870,213456,351326,39.24,60.76,23.74,165102,248833,413935,39.89,60.11,24.76
2020,"WI-08",142672,207616,350288,40.73,59.27,20.76,174153,241206,415359,41.93,58.07,20.68
2022,"WI-01",159068,168384,327452,48.58,51.42,5.06,189951,197859,387810,48.98,51.02,6.58
2022,"WI-02",260148,110900,371048,70.11,29.89,-38,310960,125998,436958,71.16,28.84,-37.78
2022,"WI-03",161629,177898,339527,47.6,52.4,7.02000000000001,185076,203572,388648,47.62,52.38,9.3
2022,"WI-04",242073,74849,316922,76.38,23.62,-50.54,260019,78208,338227,76.88,23.12,-49.22
2022,"WI-05",137896,249453,387349,35.6,64.4,31.02,176123,282495,458618,38.4,61.6,27.74
2022,"WI-06",143137,206859,349996,40.9,59.1,20.42,171968,237131,409099,42.04,57.96,20.46
2022,"WI-07",138574,214553,353127,39.24,60.76,23.74,165859,250189,416048,39.87,60.13,24.8
2022,"WI-08",140003,202375,342378,40.89,59.11,20.44,170907,234728,405635,42.13,57.87,20.28
2008,"WY-01",55973,174419,230392,24.29,75.71,53.64,73491,193559,267050,27.52,72.48,49.5
2010,"WY-01",55973,174419,230392,24.29,75.71,53.64,73491,193559,267050,27.52,72.48,49.5
2012,"WY-01",55973,174419,230392,24.29,75.71,53.64,73491,193559,267050,27.52,72.48,49.5
2014,"WY-01",55973,174419,230392,24.29,75.71,53.64,73491,193559,267050,27.52,72.48,49.5
2016,"WY-01",55973,174419,230392,24.29,75.71,53.64,73491,193559,267050,27.52,72.48,49.5
2018,"WY-01",55973,174419,230392,24.29,75.71,53.64,73491,193559,267050,27.52,72.48,49.5
2020,"WY-01",55973,174419,230392,24.29,75.71,53.64,73491,193559,267050,27.52,72.48,49.5
2022,"WY-01",55973,174419,230392,24.29,75.71,53.64,73491,193559,267050,27.52,72.48,49.5
